//MAP CONVERTED BY dmm2tgm.py THIS HEADER COMMENT PREVENTS RECONVERSION, DO NOT REMOVE
"aa" = (
/turf/open/floor/rogue/grass,
/area/rogue/outdoors/woods/churchfort/basement)
"as" = (
/obj/machinery/light/rogue/torchholder/c,
/turf/open/floor/rogue/blocks/bluestone,
/area/rogue/outdoors/woods/churchfort/basement)
"aZ" = (
/obj/effect/decal/cobbleedge{
	dir = 1;
	icon_state = "borderfall"
	},
/obj/effect/decal/cobbleedge{
	dir = 10;
	icon_state = "borderfall";
	pixel_x = -27
	},
/turf/open/floor/rogue/dirt/road,
/area/rogue/outdoors/woods/churchfort/basement)
"bi" = (
/obj/structure/stairs/stone,
/obj/structure/fluff/railing/border{
	dir = 8
	},
/obj/structure/fluff/railing/border{
	dir = 4
	},
/turf/open/floor/rogue/ruinedwood,
/area/rogue/outdoors/woods/churchfort/basement)
"dn" = (
/obj/structure/fluff/railing/border{
	dir = 8;
	icon_state = "border"
	},
/obj/structure/fluff/railing/border,
/obj/structure/flora/ausbushes/lavendergrass,
/obj/structure/flora/ausbushes/ywflowers,
/turf/open/floor/rogue/grass,
/area/rogue/outdoors/woods/churchfort/basement)
"eL" = (
/turf/closed/wall/mineral/rogue/stone/moss,
/area/rogue/outdoors/woods/churchfort/basement)
"fK" = (
/obj/structure/closet/crate/roguecloset/dark,
/obj/item/clothing/shoes/roguetown/sandals,
/obj/item/clothing/shoes/roguetown/sandals,
/obj/item/clothing/suit/roguetown/shirt/tunic/random,
/obj/item/clothing/suit/roguetown/shirt/tunic/random,
/obj/item/clothing/shoes/roguetown/sandals,
/obj/item/clothing/shoes/roguetown/sandals,
/obj/item/clothing/suit/roguetown/shirt/tunic/random,
/obj/item/clothing/suit/roguetown/shirt/tunic/random,
/turf/open/floor/rogue/twig,
/area/rogue/outdoors/woods/churchfort/basement)
"fO" = (
/obj/structure/lever{
	name = "gate lever";
	redstone_id = "church_keep_side_gate"
	},
/turf/open/floor/rogue/ruinedwood,
/area/rogue/outdoors/woods/churchfort/basement)
"gV" = (
/mob/living/carbon/human/species/goblin/npc/ambush/hell,
/turf/open/floor/rogue/ruinedwood,
/area/rogue/outdoors/woods/churchfort/basement)
"hc" = (
/obj/structure/bars/passage{
	redstone_id = "church_keep_main_gate";
	max_integrity = 9000
	},
/turf/open/floor/rogue/blocks/bluestone,
/area/rogue/outdoors/woods/churchfort/basement)
"hn" = (
/mob/living/simple_animal/hostile/retaliate/rogue/orc/spear2,
/turf/open/floor/rogue/dirt/road,
/area/rogue/outdoors/woods/churchfort/basement)
"hJ" = (
/obj/structure/bed/rogue/bedroll,
/turf/open/floor/rogue/ruinedwood,
/area/rogue/outdoors/woods/churchfort/basement)
"iL" = (
/obj/effect/decal/mossy{
	dir = 4
	},
/turf/open/floor/rogue/dirt/road,
/area/rogue/outdoors/woods/churchfort/basement)
"iM" = (
/obj/structure/fluff/railing/border{
	dir = 1;
	icon_state = "border"
	},
/obj/structure/fluff/railing/border{
	dir = 8;
	icon_state = "border"
	},
/obj/structure/flora/ausbushes/lavendergrass,
/obj/structure/flora/roguegrass/pyroclasticflowers,
/turf/open/floor/rogue/grass,
/area/rogue/outdoors/woods/churchfort/basement)
"iT" = (
/obj/machinery/light/rogue/torchholder/l,
/turf/open/floor/rogue/twig,
/area/rogue/outdoors/woods/churchfort/basement)
"ll" = (
/obj/effect/decal/cleanable/cobweb,
/turf/open/floor/rogue/ruinedwood,
/area/rogue/outdoors/woods/churchfort/basement)
"lO" = (
/obj/structure/bars/passage{
	redstone_id = "church_keep_main_gate";
	max_integrity = 9000
	},
/turf/open/floor/rogue/cobble,
/area/rogue/outdoors/woods/churchfort/basement)
"mg" = (
/obj/structure/stairs/stone{
	dir = 1
	},
/turf/open/floor/rogue/cobble,
/area/rogue/outdoors/woods/churchfort/basement)
"mp" = (
/obj/effect/decal/cobbleedge{
	dir = 1;
	icon_state = "borderfall"
	},
/obj/effect/decal/cobbleedge{
	dir = 6;
	icon_state = "borderfall";
	pixel_x = 27
	},
/turf/open/floor/rogue/grass,
/area/rogue/outdoors/woods/churchfort/basement)
"oh" = (
/obj/effect/decal/mossy{
	dir = 8
	},
/turf/open/floor/rogue/grass,
/area/rogue/outdoors/woods/churchfort/basement)
"oP" = (
/obj/structure/mineral_door/wood/donjon/stone{
	name = "South-West Tower"
	},
/turf/open/floor/rogue/ruinedwood,
/area/rogue/outdoors/woods/churchfort/basement)
"qj" = (
/obj/structure/bars/passage{
	redstone_id = "church_keep_courtyard_gate_1";
	max_integrity = 9000
	},
/turf/open/floor/rogue/blocks/bluestone,
/area/rogue/outdoors/woods/churchfort/basement)
"qV" = (
/obj/effect/decal/mossy{
	dir = 1
	},
/turf/open/floor/rogue/grass,
/area/rogue/outdoors/woods/churchfort/basement)
"sH" = (
/obj/structure/flora/roguetree/wise,
/obj/structure/flora/ausbushes/lavendergrass,
/turf/open/floor/rogue/grass,
/area/rogue/outdoors/woods/churchfort/basement)
"sY" = (
/obj/effect/decal/cleanable/cobweb{
	icon_state = "cobweb2"
	},
/turf/open/floor/rogue/ruinedwood,
/area/rogue/outdoors/woods/churchfort/basement)
"ta" = (
/obj/effect/decal/cobbleedge{
	dir = 1;
	icon_state = "borderfall"
	},
/turf/open/floor/rogue/grass,
/area/rogue/outdoors/woods/churchfort/basement)
"uh" = (
/obj/structure/fluff/railing/border,
/obj/structure/flora/ausbushes/lavendergrass,
/obj/structure/flora/ausbushes/ppflowers,
/obj/item/clothing/head/peaceflower{
	pixel_y = 5
	},
/turf/open/floor/rogue/grass,
/area/rogue/outdoors/woods/churchfort/basement)
"uN" = (
/obj/structure/mineral_door/wood/donjon/stone{
	dir = 4;
	name = "South-West Tower"
	},
/turf/open/floor/rogue/ruinedwood,
/area/rogue/outdoors/woods/churchfort/basement)
"uX" = (
/obj/effect/decal/cobbleedge{
	dir = 1;
	icon_state = "borderfall"
	},
/obj/effect/decal/cobbleedge{
	dir = 6;
	icon_state = "borderfall";
	pixel_x = 27
	},
/turf/open/floor/rogue/dirt/road,
/area/rogue/outdoors/woods/churchfort/basement)
"vu" = (
/turf/open/floor/rogue/cobble,
/area/rogue/outdoors/woods/churchfort/basement)
"vY" = (
/turf/open/floor/rogue/blocks/bluestone,
/area/rogue/outdoors/woods/churchfort/basement)
"wm" = (
/turf/open/floor/rogue/dirt/road,
/area/rogue/outdoors/woods/churchfort/basement)
"wz" = (
/obj/structure/roguetent,
/turf/open/floor/rogue/cobble,
/area/rogue/outdoors/woods/churchfort/basement)
"yv" = (
/obj/structure/fluff/railing/border{
	dir = 8;
	icon_state = "border"
	},
/obj/structure/flora/ausbushes/lavendergrass,
/obj/structure/flora/ausbushes/brflowers,
/turf/open/floor/rogue/grass,
/area/rogue/outdoors/woods/churchfort/basement)
"zo" = (
/obj/effect/decal/cobbleedge{
	dir = 1;
	icon_state = "borderfall"
	},
/obj/effect/decal/cobbleedge{
	dir = 10;
	icon_state = "borderfall";
	pixel_x = -27
	},
/turf/open/floor/rogue/grass,
/area/rogue/outdoors/woods/churchfort/basement)
"AK" = (
/obj/effect/decal/mossy{
	dir = 4
	},
/obj/effect/decal/mossy,
/turf/open/floor/rogue/dirt/road,
/area/rogue/outdoors/woods/churchfort/basement)
"BZ" = (
/obj/structure/fluff/walldeco/katholikos_banner{
	pixel_y = 25
	},
/obj/effect/decal/cobbleedge{
	dir = 1;
	icon_state = "borderfall"
	},
/turf/open/floor/rogue/dirt/road,
/area/rogue/outdoors/woods/churchfort/basement)
"Ca" = (
/obj/machinery/light/rogue/torchholder/r,
/turf/open/floor/rogue/ruinedwood,
/area/rogue/outdoors/woods/churchfort/basement)
"CQ" = (
/obj/structure/fluff/railing/border{
	dir = 1;
	icon_state = "border"
	},
/obj/structure/flora/ausbushes/lavendergrass,
/obj/structure/flora/ausbushes/ppflowers,
/turf/open/floor/rogue/grass,
/area/rogue/outdoors/woods/churchfort/basement)
"CT" = (
/obj/machinery/light/rogue/torchholder/l,
/turf/open/floor/rogue/ruinedwood,
/area/rogue/outdoors/woods/churchfort/basement)
"CW" = (
/turf/closed/wall/mineral/rogue/stone,
/area/rogue/outdoors/woods/churchfort/basement)
"Es" = (
/turf/open/water/pond,
/area/rogue/outdoors/woods/churchfort/basement)
"Gi" = (
/obj/item/natural/stone,
/obj/machinery/light/rogue/torchholder/r,
/turf/open/floor/rogue/cobble,
/area/rogue/outdoors/woods/churchfort/basement)
"Hk" = (
/mob/living/carbon/human/species/goblin/npc/ambush/hell,
/turf/open/floor/rogue/blocks/bluestone,
/area/rogue/outdoors/woods/churchfort/basement)
"HR" = (
/obj/structure/bed/rogue/inn/hay,
/obj/item/bedsheet/rogue/pelt,
/turf/open/floor/rogue/twig,
/area/rogue/outdoors/woods/churchfort/basement)
"Jo" = (
/obj/structure/fluff/walldeco/katholikos_banner{
	pixel_y = 25
	},
/obj/effect/decal/cobbleedge{
	dir = 1;
	icon_state = "borderfall"
	},
/turf/open/floor/rogue/grass,
/area/rogue/outdoors/woods/churchfort/basement)
"JL" = (
/obj/machinery/light/rogue/torchholder/l,
/turf/open/floor/rogue/cobble,
/area/rogue/outdoors/woods/churchfort/basement)
"Kr" = (
/obj/machinery/light/rogue/torchholder/l,
/turf/open/floor/rogue/blocks/bluestone,
/area/rogue/outdoors/woods/churchfort/basement)
"Kx" = (
/obj/structure/fluff/walldeco/katholikos_banner/gani{
	pixel_x = -31
	},
/obj/effect/decal/mossy{
	dir = 4
	},
/turf/open/floor/rogue/dirt/road,
/area/rogue/outdoors/woods/churchfort/basement)
"KC" = (
/turf/closed/mineral/random/rogue,
/area/rogue/outdoors/woods/churchfort/basement)
"Ma" = (
/turf/open/floor/rogue/ruinedwood,
/area/rogue/outdoors/woods/churchfort/basement)
"Mp" = (
/turf/closed/wall/mineral/rogue/tent,
/area/rogue/outdoors/woods/churchfort/basement)
"MI" = (
/mob/living/simple_animal/hostile/retaliate/rogue/orc,
/turf/open/floor/rogue/twig,
/area/rogue/outdoors/woods/churchfort/basement)
"Nb" = (
/obj/structure/bars/passage{
	redstone_id = "church_keep_side_gate";
	max_integrity = 9000
	},
/turf/open/floor/rogue/cobble,
/area/rogue/outdoors/woods/churchfort/basement)
"Nt" = (
/obj/structure/roguetent,
/turf/open/floor/rogue/ruinedwood,
/area/rogue/outdoors/woods/churchfort/basement)
"Nz" = (
/turf/open/floor/rogue/twig,
/area/rogue/outdoors/woods/churchfort/basement)
"NM" = (
/obj/structure/fluff/railing/border{
	dir = 4
	},
/obj/structure/fluff/railing/border{
	dir = 8
	},
/turf/open/transparent/openspace,
/area/rogue/outdoors/woods/churchfort/basement)
"Oy" = (
/obj/item/natural/stone,
/obj/effect/decal/cobbleedge{
	dir = 1;
	icon_state = "borderfall"
	},
/turf/open/floor/rogue/cobble,
/area/rogue/outdoors/woods/churchfort/basement)
"PK" = (
/obj/item/natural/rock,
/turf/open/floor/rogue/cobble,
/area/rogue/outdoors/woods/churchfort/basement)
"QR" = (
/obj/machinery/light/rogue/firebowl/stump,
/turf/open/floor/rogue/grass,
/area/rogue/outdoors/woods/churchfort/basement)
"RD" = (
/obj/structure/mineral_door/wood/donjon/stone{
	dir = 4;
	name = "Dormitories"
	},
/turf/open/floor/rogue/twig,
/area/rogue/outdoors/woods/churchfort/basement)
"Sd" = (
/obj/structure/flora/roguegrass/water,
/turf/open/water/pond,
/area/rogue/outdoors/woods/churchfort/basement)
"Ti" = (
/obj/effect/decal/cobbleedge{
	dir = 1;
	icon_state = "borderfall"
	},
/turf/open/floor/rogue/dirt/road,
/area/rogue/outdoors/woods/churchfort/basement)
"Ur" = (
/mob/living/simple_animal/hostile/retaliate/rogue/orc/ranged,
/turf/open/floor/rogue/grass,
/area/rogue/outdoors/woods/churchfort/basement)
"UA" = (
/obj/structure/bars/grille{
	max_integrity = 5000
	},
/turf/open/floor/rogue/blocks/bluestone,
/area/rogue/outdoors/woods/churchfort/basement)
"Zi" = (
/obj/structure/roguewindow,
/turf/open/floor/rogue/blocks/bluestone,
/area/rogue/outdoors/woods/churchfort/basement)
"Zr" = (
/mob/living/carbon/human/species/goblin/npc/ambush/hell,
/turf/open/floor/rogue/cobble,
/area/rogue/outdoors/woods/churchfort/basement)

(1,1,1) = {"
KC
KC
KC
KC
KC
eL
eL
CW
CW
Nb
CW
eL
wz
Mp
zo
"}
(2,1,1) = {"
eL
eL
CW
CW
CW
eL
ll
CT
Ma
Ma
Ma
JL
vu
wz
Oy
"}
(3,1,1) = {"
HR
MI
HR
iT
HR
eL
Mp
Mp
Mp
Zr
vu
Ma
Ma
eL
BZ
"}
(4,1,1) = {"
Nz
Nz
Nz
Nz
fK
CW
hJ
Ma
Nt
Ma
Ma
vu
fO
CW
uX
"}
(5,1,1) = {"
RD
CW
RD
eL
CW
CW
CW
CW
CW
Ma
Ma
Ma
Ma
Nb
mg
"}
(6,1,1) = {"
vu
vY
vu
Kr
vY
CW
CW
NM
bi
Ma
gV
Ma
Ma
Nb
mg
"}
(7,1,1) = {"
vu
vY
Hk
vu
vu
oP
Ma
Ma
Ma
Ma
Ma
Ma
Ma
CW
aZ
"}
(8,1,1) = {"
Hk
vu
vu
vY
vY
Zi
Ma
gV
PK
vu
Ma
Ma
Ma
eL
BZ
"}
(9,1,1) = {"
eL
CW
CW
UA
eL
eL
sY
Gi
Ma
Ma
Ma
Ca
Ma
eL
Ti
"}
(10,1,1) = {"
iL
Kx
iL
AK
qV
eL
CW
eL
Zi
uN
Zi
CW
eL
eL
mp
"}
(11,1,1) = {"
oh
oh
oh
oh
aa
Sd
Es
CW
vu
vY
vY
CW
ta
aa
aa
"}
(12,1,1) = {"
aa
aa
aa
aa
aa
aa
Sd
UA
vu
vY
vY
CW
Jo
QR
aa
"}
(13,1,1) = {"
wm
wm
wm
aa
aa
aa
aa
CW
as
Hk
vu
eL
mp
aa
aa
"}
(14,1,1) = {"
iM
yv
dn
wm
Ur
wm
wm
qj
vY
vu
vY
hc
mg
wm
wm
"}
(15,1,1) = {"
CQ
sH
uh
hn
wm
wm
wm
qj
vu
vu
vY
lO
mg
vu
vu
"}
