//MAP CONVERTED BY dmm2tgm.py THIS HEADER COMMENT PREVENTS RECONVERSION, DO NOT REMOVE
"CW" = (
/turf/open/floor/rogue/naturalstone,
/area/rogue/outdoors/woods/churchfort/basement)
"KC" = (
/turf/open/floor/rogue/metal/barograte,
/area/rogue/outdoors/woods/churchfort/basement)

(1,1,1) = {"
KC
CW
CW
CW
CW
CW
CW
CW
CW
CW
CW
CW
CW
CW
CW
"}
(2,1,1) = {"
KC
CW
CW
CW
CW
CW
CW
KC
KC
KC
KC
CW
CW
CW
CW
"}
(3,1,1) = {"
KC
CW
CW
CW
CW
CW
CW
CW
CW
CW
KC
CW
CW
CW
CW
"}
(4,1,1) = {"
KC
CW
CW
CW
CW
CW
CW
KC
KC
KC
KC
KC
KC
CW
CW
"}
(5,1,1) = {"
KC
CW
CW
CW
CW
CW
CW
CW
CW
CW
CW
CW
CW
CW
CW
"}
(6,1,1) = {"
KC
CW
CW
CW
CW
CW
CW
CW
CW
KC
KC
KC
CW
CW
CW
"}
(7,1,1) = {"
KC
CW
CW
CW
CW
CW
CW
CW
CW
CW
CW
KC
KC
CW
CW
"}
(8,1,1) = {"
KC
CW
CW
CW
CW
CW
CW
CW
CW
KC
KC
KC
CW
CW
CW
"}
(9,1,1) = {"
KC
CW
CW
CW
CW
CW
CW
CW
CW
CW
CW
CW
CW
CW
CW
"}
(10,1,1) = {"
KC
CW
CW
CW
CW
CW
CW
CW
KC
CW
CW
KC
KC
CW
CW
"}
(11,1,1) = {"
KC
CW
CW
CW
CW
CW
CW
KC
CW
CW
KC
CW
KC
CW
CW
"}
(12,1,1) = {"
KC
CW
CW
CW
CW
CW
CW
KC
CW
KC
KC
CW
KC
CW
CW
"}
(13,1,1) = {"
KC
CW
CW
CW
CW
CW
CW
CW
KC
KC
CW
CW
KC
CW
CW
"}
(14,1,1) = {"
KC
CW
CW
CW
CW
CW
CW
CW
CW
CW
CW
CW
CW
CW
CW
"}
(15,1,1) = {"
KC
KC
KC
KC
KC
KC
KC
KC
KC
KC
KC
KC
KC
KC
KC
"}
