//MAP CONVERTED BY dmm2tgm.py THIS HEADER COMMENT PREVENTS RECONVERSION, DO NOT REMOVE
"a" = (
/turf/open/floor/rogue/snow,
/area/rogue/outdoors/mountains)
"b" = (
/obj/effect/roofing_helper/twig,
/turf/closed/wall/mineral/rogue/tent{
	dir = 1
	},
/area/rogue/indoors/shelter)
"c" = (
/obj/structure/flora/roguegrass,
/turf/open/floor/rogue/grasscold,
/area/rogue/outdoors/mountains)
"e" = (
/obj/effect/spawner/lootdrop/roguetown/sewers,
/obj/effect/roofing_helper/twig,
/turf/open/floor/rogue/naturalstone,
/area/rogue/indoors/shelter)
"f" = (
/obj/effect/spawner/lootdrop/roguetown/sewers,
/obj/effect/roofing_helper/twig,
/turf/open/floor/rogue/dirt/road,
/area/rogue/indoors/shelter)
"g" = (
/obj/item/rogueweapon/spear,
/obj/effect/roofing_helper/twig,
/turf/open/floor/rogue/dirt/road,
/area/rogue/indoors/shelter)
"h" = (
/obj/structure/bed/rogue/inn/hay,
/obj/effect/spawner/lootdrop/roguetown/sewers,
/obj/effect/roofing_helper/twig,
/turf/open/floor/rogue/dirt/road,
/area/rogue/indoors/shelter)
"k" = (
/obj/structure/flora/roguegrass,
/turf/open/floor/rogue/snow,
/area/rogue/outdoors/mountains)
"q" = (
/obj/effect/roofing_helper/twig,
/turf/closed/wall/mineral/rogue/tent,
/area/rogue/indoors/shelter)
"s" = (
/obj/structure/flora/roguetree/burnt,
/turf/open/floor/rogue/snow,
/area/rogue/outdoors/mountains)
"u" = (
/obj/effect/roofing_helper/twig,
/turf/closed/wall/mineral/rogue/tent{
	dir = 8
	},
/area/rogue/indoors/shelter)
"w" = (
/obj/structure/roguetent,
/obj/effect/roofing_helper/twig,
/turf/open/floor/rogue/dirt/road,
/area/rogue/indoors/shelter)
"x" = (
/obj/structure/flora/roguegrass,
/turf/open/floor/rogue/snowpatchy,
/area/rogue/outdoors/mountains)
"y" = (
/obj/effect/roofing_helper/twig,
/turf/open/floor/rogue/naturalstone,
/area/rogue/indoors/shelter)
"B" = (
/obj/structure/closet/crate/chest/old_crate,
/obj/effect/spawner/lootdrop/roguetown/dungeon/weapons,
/obj/effect/roofing_helper/twig,
/turf/open/floor/rogue/dirt/road,
/area/rogue/indoors/shelter)
"E" = (
/obj/item/roguebin/water,
/obj/effect/roofing_helper/twig,
/turf/open/floor/rogue/dirt/road,
/area/rogue/indoors/shelter)
"H" = (
/obj/effect/roofing_helper/twig,
/turf/closed/wall/mineral/rogue/tent{
	dir = 4
	},
/area/rogue/indoors/shelter)
"L" = (
/obj/structure/flora/roguetree/burnt,
/turf/open/floor/rogue/snowpatchy,
/area/rogue/outdoors/mountains)
"M" = (
/obj/effect/decal/remains/human,
/obj/effect/roofing_helper/twig,
/turf/open/floor/rogue/dirt/road,
/area/rogue/indoors/shelter)
"N" = (
/obj/structure/bed/rogue/inn/hay,
/obj/effect/roofing_helper/twig,
/turf/open/floor/rogue/dirt/road,
/area/rogue/indoors/shelter)
"R" = (
/turf/open/floor/rogue/snowrough,
/area/rogue/outdoors/mountains)
"T" = (
/obj/effect/roofing_helper/twig,
/turf/closed/wall/mineral/rogue/wooddark,
/area/rogue/indoors/shelter)
"V" = (
/turf/open/floor/rogue/grasscold,
/area/rogue/outdoors/mountains)
"W" = (
/obj/item/natural/stone,
/turf/open/floor/rogue/snow,
/area/rogue/outdoors/mountains)
"X" = (
/turf/open/floor/rogue/snowpatchy,
/area/rogue/outdoors/mountains)
"Z" = (
/obj/effect/roofing_helper/twig,
/turf/open/floor/rogue/dirt/road,
/area/rogue/indoors/shelter)

(1,1,1) = {"
k
R
R
R
s
k
V
V
a
a
"}
(2,1,1) = {"
X
T
u
u
T
R
R
W
X
X
"}
(3,1,1) = {"
X
b
B
Z
T
u
u
T
c
X
"}
(4,1,1) = {"
x
b
Z
M
T
N
N
T
a
X
"}
(5,1,1) = {"
X
b
h
Z
Z
Z
f
q
a
X
"}
(6,1,1) = {"
X
T
H
Z
g
M
Z
w
a
X
"}
(7,1,1) = {"
X
k
T
y
b
N
E
q
X
X
"}
(8,1,1) = {"
X
k
T
e
T
H
H
T
x
X
"}
(9,1,1) = {"
X
a
T
T
T
R
k
X
X
a
"}
(10,1,1) = {"
a
V
k
R
a
a
a
a
a
L
"}
