//MAP CONVERTED BY dmm2tgm.py THIS HEADER COMMENT PREVENTS RECONVERSION, DO NOT REMOVE
"a" = (
/turf/open/floor/rogue/snow,
/area/rogue/outdoors/mountains)
"d" = (
/obj/structure/flora/roguegrass,
/obj/effect/mist{
	opacity = 1
	},
/turf/open/floor/rogue/grasscold,
/area/rogue/outdoors/mountains)
"f" = (
/obj/effect/mist{
	opacity = 1
	},
/turf/open/floor/rogue/dirt/road,
/area/rogue/outdoors/mountains)
"g" = (
/obj/structure/flora/roguegrass,
/turf/open/floor/rogue/snow,
/area/rogue/outdoors/mountains)
"j" = (
/obj/structure/fluff/railing/border{
	dir = 6
	},
/turf/open/floor/rogue/snow,
/area/rogue/outdoors/mountains)
"k" = (
/turf/open/floor/rogue/snowrough,
/area/rogue/outdoors/mountains)
"l" = (
/obj/structure/fluff/railing/border{
	dir = 4
	},
/turf/open/floor/rogue/grasscold,
/area/rogue/outdoors/mountains)
"m" = (
/obj/effect/mist{
	opacity = 1
	},
/turf/open/floor/rogue/snow,
/area/rogue/outdoors/mountains)
"o" = (
/obj/structure/flora/roguetree/stump/burnt,
/turf/open/floor/rogue/snow,
/area/rogue/outdoors/mountains)
"p" = (
/obj/structure/flora/roguegrass,
/turf/open/floor/rogue/dirt/road,
/area/rogue/outdoors/mountains)
"q" = (
/obj/structure/flora/roguetree/stump/burnt,
/turf/open/floor/rogue/dirt/road,
/area/rogue/outdoors/mountains)
"r" = (
/obj/structure/fluff/railing/border{
	dir = 8
	},
/turf/open/floor/rogue/grasscold,
/area/rogue/outdoors/mountains)
"s" = (
/obj/item/natural/rock,
/turf/open/floor/rogue/snow,
/area/rogue/outdoors/mountains)
"v" = (
/turf/open/floor/rogue/grasscold,
/area/rogue/outdoors/mountains)
"w" = (
/obj/structure/closet/crate/chest/neu,
/obj/effect/spawner/lootdrop/roguetown/dungeon/clothing,
/obj/effect/spawner/lootdrop/roguetown/dungeon/clothing,
/obj/effect/spawner/lootdrop/roguetown/dungeon/tools,
/obj/effect/spawner/lootdrop/roguetown/dungeon/weapons,
/turf/open/floor/rogue/dirt/road,
/area/rogue/outdoors/mountains)
"A" = (
/mob/living/simple_animal/hostile/rogue/skeleton/bow{
	color = '#325ea8";
	name = "Frost Geist";
	health = 250;
	ranged_cooldown_time = 10;
	light_power = 3;
	light_range = 6;
	light_color = "#325ea8"
	},
/turf/open/floor/rogue/cobble,
/area/rogue/outdoors/mountains)
"D" = (
/obj/structure/fluff/railing/border{
	dir = 5
	},
/turf/open/floor/rogue/grasscold,
/area/rogue/outdoors/mountains)
"E" = (
/turf/open/floor/rogue/dirt/road,
/area/rogue/outdoors/mountains)
"H" = (
/obj/structure/fluff/railing/border,
/turf/open/floor/rogue/snow,
/area/rogue/outdoors/mountains)
"I" = (
/obj/structure/fluff/railing/border{
	icon_state = "border";
	dir = 10
	},
/turf/open/floor/rogue/grasscold,
/area/rogue/outdoors/mountains)
"N" = (
/obj/structure/fluff/railing/border{
	dir = 9
	},
/turf/open/floor/rogue/grasscold,
/area/rogue/outdoors/mountains)
"O" = (
/obj/effect/mist{
	opacity = 1
	},
/turf/open/floor/rogue/snowrough,
/area/rogue/outdoors/mountains)
"Q" = (
/obj/structure/flora/roguegrass,
/turf/open/floor/rogue/grasscold,
/area/rogue/outdoors/mountains)
"S" = (
/obj/structure/fluff/railing/border{
	dir = 1;
	icon_state = "border"
	},
/turf/open/floor/rogue/grasscold,
/area/rogue/outdoors/mountains)
"U" = (
/obj/structure/flora/roguegrass,
/obj/effect/mist{
	opacity = 1
	},
/turf/open/floor/rogue/snowrough,
/area/rogue/outdoors/mountains)
"V" = (
/obj/structure/closet/crate/chest/neu,
/obj/effect/spawner/lootdrop/roguetown/dungeon/clothing,
/obj/effect/spawner/lootdrop/roguetown/dungeon/clothing,
/obj/effect/spawner/lootdrop/roguetown/dungeon/armor,
/obj/effect/spawner/lootdrop/roguetown/dungeon/money,
/obj/effect/spawner/lootdrop/roguetown/dungeon/money,
/turf/open/floor/rogue/dirt/road,
/area/rogue/outdoors/mountains)
"W" = (
/obj/effect/mist{
	opacity = 1
	},
/turf/open/floor/rogue/grasscold,
/area/rogue/outdoors/mountains)
"Z" = (
/obj/structure/flora/roguegrass,
/obj/effect/mist{
	opacity = 1
	},
/turf/open/floor/rogue/snow,
/area/rogue/outdoors/mountains)

(1,1,1) = {"
a
a
Z
m
E
m
W
m
s
a
"}
(2,1,1) = {"
s
d
a
a
O
O
a
m
m
m
"}
(3,1,1) = {"
O
v
E
E
k
j
l
D
a
m
"}
(4,1,1) = {"
k
d
v
E
E
H
A
S
m
a
"}
(5,1,1) = {"
m
k
v
E
V
I
r
N
g
m
"}
(6,1,1) = {"
a
U
v
v
w
E
v
v
d
a
"}
(7,1,1) = {"
O
v
v
j
l
D
v
Q
Q
W
"}
(8,1,1) = {"
f
v
v
H
A
S
g
v
m
a
"}
(9,1,1) = {"
m
a
v
I
r
N
p
W
v
q
"}
(10,1,1) = {"
o
m
m
W
Z
W
m
E
m
s
"}
