//MAP CONVERTED BY dmm2tgm.py THIS HEADER COMMENT PREVENTS RECONVERSION, DO NOT REMOVE
"a" = (
/turf/open/floor/rogue/snow,
/area/rogue/outdoors/mountains)
"b" = (
/obj/structure/flora/roguetree/stump,
/turf/open/floor/rogue/snowpatchy,
/area/rogue/outdoors/mountains)
"c" = (
/obj/structure/flora/roguegrass,
/turf/open/floor/rogue/grasscold,
/area/rogue/outdoors/mountains)
"g" = (
/obj/structure/flora/roguetree/stump/burnt,
/turf/open/floor/rogue/snow,
/area/rogue/outdoors/mountains)
"k" = (
/obj/structure/flora/roguegrass,
/turf/open/floor/rogue/snow,
/area/rogue/outdoors/mountains)
"x" = (
/obj/structure/flora/roguegrass,
/turf/open/floor/rogue/snowpatchy,
/area/rogue/outdoors/mountains)
"E" = (
/obj/structure/flora/roguetree/burnt,
/turf/open/floor/rogue/grasscold,
/area/rogue/outdoors/mountains)
"H" = (
/turf/open/water/pond,
/area/rogue/outdoors/mountains)
"L" = (
/obj/structure/flora/roguetree/burnt,
/turf/open/floor/rogue/snowpatchy,
/area/rogue/outdoors/mountains)
"N" = (
/obj/effect/spawner/lootdrop/roguetown/sewers,
/turf/open/floor/rogue/snowpatchy,
/area/rogue/outdoors/mountains)
"T" = (
/obj/structure/flora/roguetree/stump/log,
/obj/effect/spawner/lootdrop/roguetown/sewers,
/turf/open/floor/rogue/snowpatchy,
/area/rogue/outdoors/mountains)
"V" = (
/turf/open/floor/rogue/grasscold,
/area/rogue/outdoors/mountains)
"X" = (
/turf/open/floor/rogue/snowpatchy,
/area/rogue/outdoors/mountains)

(1,1,1) = {"
a
X
X
X
a
a
a
V
V
g
"}
(2,1,1) = {"
X
N
X
X
X
X
L
X
X
X
"}
(3,1,1) = {"
c
b
X
k
X
H
c
X
c
X
"}
(4,1,1) = {"
V
X
H
H
H
H
H
a
a
X
"}
(5,1,1) = {"
V
X
H
H
H
H
H
H
a
X
"}
(6,1,1) = {"
a
X
L
H
H
H
H
H
a
X
"}
(7,1,1) = {"
V
V
X
H
H
H
H
a
X
X
"}
(8,1,1) = {"
c
V
X
x
X
H
x
T
x
X
"}
(9,1,1) = {"
V
V
V
V
V
V
V
a
X
V
"}
(10,1,1) = {"
a
L
X
a
X
X
a
V
V
E
"}
