//MAP CONVERTED BY dmm2tgm.py THIS HEADER COMMENT PREVENTS RECONVERSION, DO NOT REMOVE
"ar" = (
/obj/effect/decal/cleanable/blood,
/turf/open/floor/rogue/volcanic,
/area/rogue/outdoors/mountains/decap/hell)
"aJ" = (
/obj/effect/spawner/lootdrop/roguetown/sewers,
/turf/open/floor/rogue/volcanic,
/area/rogue/outdoors/mountains/decap/hell)
"bS" = (
/obj/effect/decal/cleanable/blood/tracks,
/turf/open/floor/rogue/naturalstone,
/area/rogue/outdoors/mountains/decap/hell)
"bX" = (
/obj/structure/roguetent,
/turf/open/floor/rogue/naturalstone,
/area/rogue/indoors/shelter/mountains/decap)
"dd" = (
/turf/open/floor/rogue/naturalstone,
/area/rogue/outdoors/mountains/decap/hell)
"dp" = (
/obj/effect/decal/cleanable/blood/tracks,
/obj/item/natural/bundle/stick,
/turf/open/floor/rogue/cobble/mossy,
/area/rogue/indoors/shelter/mountains/decap)
"du" = (
/obj/item/lockpick,
/turf/open/floor/rogue/cobble/mossy,
/area/rogue/indoors/shelter/mountains/decap)
"dE" = (
/turf/open/floor/rogue/cobble/mossy,
/area/rogue/indoors/shelter/mountains/decap)
"gd" = (
/obj/item/rogueore/gold,
/turf/open/floor/rogue/cobble,
/area/rogue/indoors/shelter/mountains/decap)
"gQ" = (
/obj/item/rogueore/iron,
/turf/open/floor/rogue/naturalstone,
/area/rogue/indoors/shelter/mountains/decap)
"gS" = (
/obj/structure/closet/dirthole/closed/loot,
/turf/open/floor/rogue/cobble,
/area/rogue/indoors/shelter/mountains/decap)
"ht" = (
/obj/structure/fluff/grindwheel,
/turf/open/floor/rogue/cobble/mossy,
/area/rogue/indoors/shelter/mountains/decap)
"hC" = (
/obj/effect/decal/cleanable/blood,
/obj/effect/decal/cleanable/blood/tracks,
/turf/open/floor/rogue/metal{
	icon_state = "plating2"
	},
/area/rogue/outdoors/mountains/decap/hell)
"jl" = (
/obj/structure/flora/roguegrass/maneater/real,
/turf/open/floor/rogue/cobble/mossy,
/area/rogue/indoors/shelter/mountains/decap)
"lV" = (
/obj/structure/fluff/millstone,
/turf/open/floor/rogue/cobble/mossy,
/area/rogue/indoors/shelter/mountains/decap)
"mZ" = (
/obj/effect/spawner/lootdrop/roguetown/sewers,
/turf/open/floor/rogue/cobble/mossy,
/area/rogue/indoors/shelter/mountains/decap)
"ny" = (
/obj/item/rogueore/silver,
/turf/open/floor/rogue/naturalstone,
/area/rogue/indoors/shelter/mountains/decap)
"qC" = (
/obj/effect/decal/cleanable/blood,
/turf/open/floor/rogue/naturalstone,
/area/rogue/outdoors/mountains/decap/hell)
"qE" = (
/obj/effect/spawner/lootdrop/roguetown/sewers,
/turf/open/floor/rogue/naturalstone,
/area/rogue/indoors/shelter/mountains/decap)
"qK" = (
/turf/open/floor/rogue/volcanic,
/area/rogue/outdoors/mountains/decap/hell)
"rd" = (
/obj/item/reagent_containers/powder/salt,
/turf/open/floor/rogue/volcanic,
/area/rogue/outdoors/mountains/decap/hell)
"sb" = (
/obj/effect/decal/cleanable/blood/tracks,
/turf/open/floor/rogue/metal{
	icon_state = "plating2"
	},
/area/rogue/outdoors/mountains/decap/hell)
"tt" = (
/obj/item/natural/stone,
/turf/open/floor/rogue/naturalstone,
/area/rogue/outdoors/mountains/decap/hell)
"tS" = (
/obj/structure/roguetent,
/obj/effect/decal/cleanable/blood/tracks,
/turf/open/floor/rogue/naturalstone,
/area/rogue/indoors/shelter/mountains/decap)
"uj" = (
/obj/structure/spider/stickyweb,
/turf/open/floor/rogue/cobble/mossy,
/area/rogue/indoors/shelter/mountains/decap)
"wR" = (
/obj/item/rogueore/iron,
/turf/open/floor/rogue/cobble,
/area/rogue/indoors/shelter/mountains/decap)
"xG" = (
/obj/structure/fluff/walldeco/chains,
/obj/item/natural/stone,
/turf/open/floor/rogue/naturalstone,
/area/rogue/indoors/shelter/mountains/decap)
"yf" = (
/obj/item/reagent_containers/glass/bucket/wooden,
/turf/open/floor/rogue/naturalstone,
/area/rogue/indoors/shelter/mountains/decap)
"yr" = (
/obj/machinery/light/rogue/firebowl/standing/blue,
/turf/open/floor/rogue/cobble/mossy,
/area/rogue/indoors/shelter/mountains/decap)
"zU" = (
/obj/structure/spider/stickyweb,
/obj/item/rogueore/copper,
/turf/open/floor/rogue/cobble/mossy,
/area/rogue/indoors/shelter/mountains/decap)
"zW" = (
/obj/structure/table/wood{
	icon_state = "largetable";
	dir = 6
	},
/obj/item/rogueore/tin,
/turf/open/floor/rogue/cobble,
/area/rogue/indoors/shelter/mountains/decap)
"Am" = (
/turf/open/lava/acid,
/area/rogue/indoors/shelter/mountains/decap)
"AW" = (
/obj/item/rogueweapon/huntingknife/idagger/navaja,
/turf/open/floor/rogue/cobble/mossy,
/area/rogue/indoors/shelter/mountains/decap)
"Bj" = (
/obj/structure/table/wood{
	icon_state = "largetable";
	dir = 4
	},
/obj/item/reagent_containers/glass/cup/wooden,
/turf/open/floor/rogue/cobble,
/area/rogue/indoors/shelter/mountains/decap)
"Ch" = (
/obj/machinery/light/rogue/firebowl/standing/blue,
/turf/open/floor/rogue/naturalstone,
/area/rogue/indoors/shelter/mountains/decap)
"Cu" = (
/obj/structure/mineral_door/wood/donjon,
/turf/open/floor/rogue/naturalstone,
/area/rogue/indoors/shelter/mountains/decap)
"Cy" = (
/turf/open/lava/acid,
/area/rogue/outdoors/mountains/decap/hell)
"CY" = (
/obj/structure/spider/stickyweb,
/obj/structure/closet/dirthole/grave,
/turf/open/floor/rogue/cobble/mossy,
/area/rogue/indoors/shelter/mountains/decap)
"Dd" = (
/obj/structure/table/wood{
	icon_state = "largetable";
	dir = 8
	},
/obj/item/candle/yellow,
/turf/open/floor/rogue/cobble,
/area/rogue/indoors/shelter/mountains/decap)
"Ef" = (
/obj/item/reagent_containers/powder/salt,
/turf/open/floor/rogue/naturalstone,
/area/rogue/outdoors/mountains/decap/hell)
"GL" = (
/obj/structure/closet/crate/chest/old_crate,
/turf/open/floor/rogue/naturalstone,
/area/rogue/indoors/shelter/mountains/decap)
"HF" = (
/obj/structure/handcart{
	dir = 8
	},
/turf/open/floor/rogue/naturalstone,
/area/rogue/indoors/shelter/mountains/decap)
"Iy" = (
/turf/open/floor/rogue/cobble,
/area/rogue/indoors/shelter/mountains/decap)
"Jp" = (
/obj/structure/flora/shroomstump,
/turf/open/floor/rogue/naturalstone,
/area/rogue/indoors/shelter/mountains/decap)
"KC" = (
/obj/item/clothing/suit/roguetown/shirt/shortshirt/random,
/obj/structure/rack/rogue,
/turf/open/floor/rogue/cobble/mossy,
/area/rogue/indoors/shelter/mountains/decap)
"Ml" = (
/obj/structure/bars/grille{
	density = 1
	},
/turf/open/floor/rogue/volcanic,
/area/rogue/outdoors/mountains/decap/hell)
"Ox" = (
/obj/structure/roguetent,
/turf/open/floor/rogue/cobble/mossy,
/area/rogue/indoors/shelter/mountains/decap)
"Pu" = (
/obj/structure/closet/dirthole/closed/loot,
/turf/open/floor/rogue/cobble/mossy,
/area/rogue/indoors/shelter/mountains/decap)
"PU" = (
/obj/effect/decal/cleanable/blood/tracks,
/turf/open/floor/rogue/cobble/mossy,
/area/rogue/indoors/shelter/mountains/decap)
"RS" = (
/turf/open/floor/rogue/naturalstone,
/area/rogue/indoors/shelter/mountains/decap)
"Tn" = (
/obj/structure/fluff/walldeco/chains,
/turf/open/floor/rogue/cobble,
/area/rogue/indoors/shelter/mountains/decap)
"Ud" = (
/obj/item/rogueore/silver,
/turf/open/floor/rogue/cobble/mossy,
/area/rogue/indoors/shelter/mountains/decap)
"Vl" = (
/obj/structure/fluff/walldeco/chains,
/turf/open/floor/rogue/cobble/mossy,
/area/rogue/indoors/shelter/mountains/decap)
"VE" = (
/turf/open/floor/rogue/metal{
	icon_state = "plating2"
	},
/area/rogue/outdoors/mountains/decap/hell)
"WI" = (
/obj/item/natural/stone,
/turf/open/floor/rogue/volcanic,
/area/rogue/outdoors/mountains/decap/hell)
"XD" = (
/obj/structure/table/wood{
	icon_state = "largetable";
	dir = 10
	},
/turf/open/floor/rogue/cobble,
/area/rogue/indoors/shelter/mountains/decap)
"YZ" = (
/turf/closed/wall/mineral/rogue/stone/blue_moss,
/area/rogue/indoors/shelter/mountains/decap)
"ZO" = (
/obj/item/natural/stone,
/turf/open/floor/rogue/cobble/mossy,
/area/rogue/indoors/shelter/mountains/decap)

(1,1,1) = {"
qK
qK
qK
WI
qK
qK
qK
qK
dd
dd
dd
qK
dd
YZ
YZ
"}
(2,1,1) = {"
qK
YZ
YZ
YZ
YZ
YZ
YZ
YZ
YZ
dd
qK
qK
qK
YZ
YZ
"}
(3,1,1) = {"
qK
YZ
CY
zU
yr
GL
RS
qE
YZ
rd
Cy
Cy
qK
qK
Ml
"}
(4,1,1) = {"
qK
YZ
CY
uj
Pu
Pu
gQ
xG
bX
dd
Cy
Cy
qK
qK
Ml
"}
(5,1,1) = {"
qK
YZ
Pu
Ud
Pu
Pu
dp
PU
tS
bS
hC
sb
aJ
ar
Ml
"}
(6,1,1) = {"
qK
YZ
CY
Vl
Pu
Pu
dE
AW
Ox
dd
Cy
Cy
qK
qK
Ml
"}
(7,1,1) = {"
qK
YZ
gS
jl
ZO
Tn
gd
dE
YZ
ar
Cy
Cy
dd
YZ
YZ
"}
(8,1,1) = {"
qK
YZ
Dd
XD
Iy
YZ
YZ
YZ
YZ
dd
VE
VE
WI
YZ
YZ
"}
(9,1,1) = {"
qK
YZ
Bj
zW
Iy
YZ
lV
ht
YZ
qK
Cy
Cy
Ef
dd
Ml
"}
(10,1,1) = {"
qK
YZ
Am
wR
dE
YZ
du
HF
YZ
qK
Cy
Cy
dd
qC
Ml
"}
(11,1,1) = {"
qK
YZ
Am
dE
mZ
Cu
ny
yf
YZ
ar
VE
VE
qK
dd
Ml
"}
(12,1,1) = {"
dd
YZ
Am
KC
Ch
YZ
qE
Jp
YZ
qK
Cy
Cy
ar
aJ
Ml
"}
(13,1,1) = {"
tt
YZ
YZ
YZ
YZ
YZ
YZ
YZ
YZ
dd
qK
qK
qK
ar
Ml
"}
(14,1,1) = {"
dd
dd
dd
dd
qK
qK
qK
dd
dd
tt
qC
dd
qK
YZ
YZ
"}
(15,1,1) = {"
qK
tt
qK
qK
qK
qK
qK
qK
dd
qK
qK
qK
qK
YZ
YZ
"}
