//MAP CONVERTED BY dmm2tgm.py THIS HEADER COMMENT PREVENTS RECONVERSION, DO NOT REMOVE
"a" = (
/obj/item/natural/stone,
/turf/open/floor/rogue/grass,
/area/rogue/outdoors/woods)
"b" = (
/obj/structure/flora/roguetree/stump,
/turf/open/floor/rogue/grass,
/area/rogue/outdoors/woods)
"c" = (
/obj/structure/fluff/edge/natural/grass{
	dir = 6
	},
/turf/open/water/pond,
/area/rogue/outdoors/woods)
"d" = (
/obj/structure/fluff/edge/natural/grass{
	dir = 9
	},
/turf/open/water/pond,
/area/rogue/outdoors/woods)
"f" = (
/obj/structure/flora/roguegrass,
/turf/open/floor/rogue/dirt,
/area/rogue/outdoors/woods)
"g" = (
/obj/structure/flora/roguetree/stump/burnt,
/turf/open/floor/rogue/grass,
/area/rogue/outdoors/woods)
"h" = (
/obj/structure/fluff/edge/natural/grass{
	dir = 6
	},
/obj/structure/fluff/edge/natural/grass/corner{
	dir = 1
	},
/obj/structure/crabnest,
/turf/open/water/pond,
/area/rogue/outdoors/woods)
"j" = (
/obj/structure/fluff/edge/natural/grass{
	dir = 5
	},
/obj/structure/fluff/edge/natural/grass/corner{
	dir = 8
	},
/turf/open/water/pond,
/area/rogue/outdoors/woods)
"k" = (
/obj/structure/flora/roguegrass,
/turf/open/floor/rogue/grass,
/area/rogue/outdoors/woods)
"l" = (
/obj/structure/fluff/edge/natural/grass,
/obj/structure/fluff/edge/natural/grass{
	dir = 1
	},
/turf/open/water/pond,
/area/rogue/outdoors/woods)
"m" = (
/obj/structure/fluff/edge/natural/grass{
	dir = 4
	},
/obj/structure/flora/roguegrass/water,
/turf/open/water/pond,
/area/rogue/outdoors/woods)
"n" = (
/obj/structure/flora/roguegrass/water,
/obj/structure/fluff/edge/natural/grass{
	dir = 9
	},
/obj/structure/fluff/edge/natural/grass/corner{
	dir = 4
	},
/turf/open/water/pond,
/area/rogue/outdoors/woods)
"q" = (
/obj/item/natural/stone,
/turf/open/floor/rogue/dirt,
/area/rogue/outdoors/woods)
"r" = (
/obj/structure/fluff/edge/natural/grass{
	dir = 10
	},
/obj/structure/fluff/edge/natural/grass{
	dir = 10
	},
/turf/open/water/pond,
/area/rogue/outdoors/woods)
"t" = (
/obj/structure/flora/roguegrass/water,
/obj/structure/fluff/edge/natural/grass{
	dir = 9
	},
/turf/open/water/pond,
/area/rogue/outdoors/woods)
"u" = (
/obj/structure/flora/roguegrass/water,
/turf/open/floor/rogue/grass,
/area/rogue/outdoors/woods)
"v" = (
/obj/structure/flora/roguegrass/bush,
/turf/open/floor/rogue/dirt,
/area/rogue/outdoors/woods)
"w" = (
/obj/structure/flora/roguetree/stump/log,
/turf/open/floor/rogue/dirt,
/area/rogue/outdoors/woods)
"A" = (
/obj/structure/fluff/edge/natural/grass{
	dir = 4
	},
/obj/structure/fluff/edge/natural/grass/corner{
	dir = 4
	},
/mob/living/simple_animal/hostile/retaliate/rogue/mudcrab,
/turf/open/water/pond,
/area/rogue/outdoors/woods)
"C" = (
/obj/structure/fluff/edge/natural/grass{
	dir = 10
	},
/turf/open/water/pond,
/area/rogue/outdoors/woods)
"D" = (
/obj/structure/fluff/edge/natural/grass/corner{
	dir = 4
	},
/obj/structure/fluff/edge/natural/grass,
/turf/open/water/pond,
/area/rogue/outdoors/woods)
"E" = (
/turf/open/floor/rogue/grass,
/area/rogue/outdoors/woods)
"F" = (
/obj/structure/fluff/edge/natural/grass/corner,
/obj/structure/flora/roguegrass/water,
/obj/structure/fluff/edge/natural/grass/corner{
	dir = 4
	},
/turf/open/water/pond,
/area/rogue/outdoors/woods)
"G" = (
/obj/structure/flora/roguegrass/water,
/obj/structure/fluff/edge/natural/grass/corner{
	dir = 1
	},
/mob/living/simple_animal/hostile/retaliate/rogue/mudcrab,
/turf/open/water/pond,
/area/rogue/outdoors/woods)
"H" = (
/obj/structure/fluff/edge/natural/grass/corner{
	dir = 8
	},
/obj/structure/flora/roguegrass/water,
/turf/open/water/pond,
/area/rogue/outdoors/woods)
"I" = (
/obj/structure/fluff/edge/natural/grass/corner{
	dir = 1
	},
/obj/structure/crabnest,
/turf/open/water/pond,
/area/rogue/outdoors/woods)
"J" = (
/obj/structure/fluff/edge/natural/grass/corner,
/obj/structure/fluff/edge/natural/grass{
	dir = 1
	},
/turf/open/water/pond,
/area/rogue/outdoors/woods)
"K" = (
/obj/structure/fluff/edge/natural/grass,
/obj/structure/fluff/edge/natural/grass{
	dir = 1
	},
/mob/living/simple_animal/hostile/retaliate/rogue/mudcrab,
/turf/open/water/pond,
/area/rogue/outdoors/woods)
"L" = (
/obj/structure/fluff/edge/natural/grass{
	dir = 5
	},
/turf/open/water/pond,
/area/rogue/outdoors/woods)
"N" = (
/obj/structure/fluff/edge/natural/grass{
	dir = 8
	},
/turf/open/water/pond,
/area/rogue/outdoors/woods)
"S" = (
/obj/structure/fluff/edge/natural/grass/corner{
	dir = 1
	},
/obj/structure/fluff/edge/natural/grass{
	dir = 6
	},
/turf/open/water/pond,
/area/rogue/outdoors/woods)
"T" = (
/turf/open/floor/rogue/dirt,
/area/rogue/outdoors/woods)
"U" = (
/obj/structure/fluff/edge/natural/grass/corner{
	dir = 1
	},
/obj/structure/fluff/edge/natural/grass{
	dir = 8
	},
/obj/structure/crabnest,
/turf/open/water/pond,
/area/rogue/outdoors/woods)
"V" = (
/obj/structure/fluff/edge/natural/grass/corner{
	dir = 4
	},
/obj/structure/fluff/edge/natural/grass{
	dir = 4
	},
/mob/living/simple_animal/hostile/retaliate/rogue/mudcrab,
/turf/open/water/pond,
/area/rogue/outdoors/woods)
"W" = (
/obj/structure/fluff/edge/natural/grass/corner,
/obj/structure/fluff/edge/natural/grass{
	dir = 4
	},
/turf/open/water/pond,
/area/rogue/outdoors/woods)
"X" = (
/obj/structure/flora/roguegrass/bush,
/turf/open/floor/rogue/grass,
/area/rogue/outdoors/woods)
"Y" = (
/obj/structure/flora/roguegrass/water,
/obj/structure/fluff/edge/natural/grass{
	dir = 10
	},
/turf/open/water/pond,
/area/rogue/outdoors/woods)

(1,1,1) = {"
T
f
E
v
T
E
E
k
E
g
"}
(2,1,1) = {"
T
E
E
k
q
E
d
m
C
E
"}
(3,1,1) = {"
k
b
d
r
E
n
U
N
c
k
"}
(4,1,1) = {"
E
d
I
H
A
S
k
E
E
k
"}
(5,1,1) = {"
a
L
F
N
J
E
t
C
E
X
"}
(6,1,1) = {"
X
k
K
E
j
W
G
H
Y
E
"}
(7,1,1) = {"
E
a
l
E
k
D
N
N
c
E
"}
(8,1,1) = {"
k
E
j
W
V
h
k
E
k
E
"}
(9,1,1) = {"
E
u
E
L
c
k
E
v
T
w
"}
(10,1,1) = {"
T
T
k
E
E
E
q
T
T
k
"}
