//MAP CONVERTED BY dmm2tgm.py THIS HEADER COMMENT PREVENTS RECONVERSION, DO NOT REMOVE
"a" = (
/obj/effect/spawner/mobspawner/wolf,
/obj/effect/roofing_helper/stone,
/turf/open/floor/rogue/naturalstone,
/area/rogue/under/cave)
"b" = (
/obj/structure/fluff/edge/natural/stone{
	dir = 6
	},
/obj/effect/roofing_helper/stone,
/turf/open/water/pond,
/area/rogue/under/cave)
"c" = (
/obj/item/natural/rock/copper,
/obj/effect/roofing_helper/stone,
/turf/open/floor/rogue/naturalstone,
/area/rogue/under/cave)
"g" = (
/obj/structure/flora/roguetree/stump/burnt,
/turf/open/floor/rogue/grass,
/area/rogue/outdoors/woods)
"i" = (
/obj/structure/flora/roguegrass,
/turf/open/floor/rogue/dirt,
/area/rogue/under/cave)
"k" = (
/obj/structure/flora/roguegrass,
/turf/open/floor/rogue/grass,
/area/rogue/outdoors/woods)
"p" = (
/mob/living/simple_animal/hostile/retaliate/rogue/wolf,
/obj/effect/roofing_helper/stone,
/turf/open/floor/rogue/naturalstone,
/area/rogue/under/cave)
"w" = (
/obj/effect/spawner/mobspawner/wolf,
/obj/effect/roofing_helper/stone,
/turf/open/floor/rogue/dirt,
/area/rogue/under/cave)
"E" = (
/turf/open/floor/rogue/grass,
/area/rogue/outdoors/woods)
"F" = (
/obj/structure/flora/roguegrass/water,
/turf/open/floor/rogue/grass,
/area/rogue/outdoors/woods)
"H" = (
/obj/effect/roofing_helper/stone,
/turf/open/floor/rogue/dirt,
/area/rogue/under/cave)
"M" = (
/obj/structure/fluff/edge/natural/stone{
	dir = 1
	},
/obj/effect/roofing_helper/stone,
/turf/open/water/pond,
/area/rogue/under/cave)
"N" = (
/obj/item/reagent_containers/powder/salt,
/obj/effect/roofing_helper/stone,
/turf/open/floor/rogue/dirt/road,
/area/rogue/under/cave)
"P" = (
/obj/item/reagent_containers/food/snacks/rogue/meat/coppiette,
/obj/effect/roofing_helper/stone,
/obj/effect/spawner/lootdrop/roguetown/sewers,
/turf/open/floor/rogue/naturalstone,
/area/rogue/under/cave)
"Q" = (
/obj/effect/roofing_helper/stone,
/turf/open/floor/rogue/naturalstone,
/area/rogue/under/cave)
"T" = (
/mob/living/simple_animal/hostile/retaliate/rogue/wolf,
/obj/effect/roofing_helper/stone,
/turf/open/floor/rogue/dirt/road,
/area/rogue/under/cave)
"V" = (
/obj/effect/roofing_helper/stone,
/turf/closed/mineral/random/rogue,
/area/rogue/under/cave)
"W" = (
/obj/structure/fluff/edge/natural/stone/corner{
	dir = 4
	},
/obj/effect/roofing_helper/stone,
/turf/open/water/pond,
/area/rogue/under/cave)
"X" = (
/obj/structure/flora/roguegrass/bush,
/turf/open/floor/rogue/grass,
/area/rogue/outdoors/woods)

(1,1,1) = {"
E
E
E
X
E
E
E
k
E
g
"}
(2,1,1) = {"
E
E
V
V
V
V
V
V
E
E
"}
(3,1,1) = {"
k
V
V
V
Q
a
T
V
E
E
"}
(4,1,1) = {"
k
V
V
V
p
c
Q
V
V
E
"}
(5,1,1) = {"
E
V
W
b
c
N
T
V
V
X
"}
(6,1,1) = {"
X
V
M
c
H
V
V
V
V
V
"}
(7,1,1) = {"
E
V
V
P
H
w
H
V
V
V
"}
(8,1,1) = {"
k
E
V
V
V
V
H
H
V
V
"}
(9,1,1) = {"
E
F
E
i
i
H
H
H
V
E
"}
(10,1,1) = {"
E
E
E
V
V
V
V
V
V
E
"}
