//MAP CONVERTED BY dmm2tgm.py THIS HEADER COMMENT PREVENTS RECONVERSION, DO NOT REMOVE
"ab" = (
/obj/item/grown/log/tree/stick,
/turf/open/floor/rogue/grass,
/area/rogue/outdoors/woods)
"aJ" = (
/obj/item/natural/fibers,
/turf/open/floor/rogue/grass,
/area/rogue/outdoors/woods)
"gB" = (
/turf/closed/mineral/random/rogue,
/area/rogue/under/cave)
"lt" = (
/turf/open/floor/rogue/grass,
/area/rogue/outdoors/woods)
"lB" = (
/turf/open/floor/rogue/grassyel,
/area/rogue/outdoors/mountains)
"og" = (
/obj/item/natural/stone,
/turf/open/floor/rogue/grass,
/area/rogue/outdoors/woods)
"oL" = (
/turf/open/water/pond,
/area/rogue/outdoors/woods)
"sX" = (
/turf/open/transparent/openspace,
/area/rogue/outdoors/woods)
"sY" = (
/obj/structure/flora/newtree,
/turf/open/floor/rogue/grass,
/area/rogue/outdoors/woods)
"tn" = (
/obj/structure/spacevine,
/turf/open/floor/rogue/grass,
/area/rogue/outdoors/woods)
"tS" = (
/obj/structure/flora/roguegrass,
/turf/open/floor/rogue/grass,
/area/rogue/outdoors/woods)
"uu" = (
/obj/structure/flora/roguegrass,
/turf/open/floor/rogue/grassyel,
/area/rogue/outdoors/mountains)
"wj" = (
/obj/item/natural/stone,
/obj/structure/flora/roguegrass,
/turf/open/floor/rogue/grass,
/area/rogue/outdoors/woods)
"xQ" = (
/turf/open/floor/rogue/naturalstone,
/area/rogue/outdoors/woods)
"CZ" = (
/obj/item/natural/thorn,
/turf/open/floor/rogue/grass,
/area/rogue/outdoors/woods)
"Dd" = (
/turf/open/floor/rogue/dirt,
/area/rogue/outdoors/woods)
"GL" = (
/obj/structure/flora/roguetree/stump/log,
/turf/open/floor/rogue/grass,
/area/rogue/outdoors/woods)
"KT" = (
/turf/open/transparent/openspace,
/area/rogue/outdoors/mountains)
"Tx" = (
/obj/structure/flora/roguegrass/water,
/turf/open/water/pond,
/area/rogue/outdoors/woods)
"UM" = (
/turf/open/floor/rogue/ruinedwood,
/area/rogue/outdoors/woods)
"WJ" = (
/obj/effect/roofing_helper/stone,
/turf/closed/mineral/random/rogue,
/area/rogue/under/cave)

(1,1,1) = {"
lt
lt
lt
lt
lt
lt
lt
tS
lt
lt
lt
lt
gB
ab
tS
"}
(2,1,1) = {"
aJ
tn
gB
gB
xQ
lt
lt
lt
lt
lt
gB
gB
gB
gB
lt
"}
(3,1,1) = {"
ab
gB
gB
gB
tS
lt
gB
gB
lt
og
gB
gB
gB
gB
lt
"}
(4,1,1) = {"
lt
tS
tS
lt
lt
oL
gB
gB
lt
lt
xQ
gB
gB
gB
lt
"}
(5,1,1) = {"
og
tS
lt
lt
gB
Tx
oL
oL
lt
tS
lt
xQ
xQ
tS
lt
"}
(6,1,1) = {"
lt
Dd
Dd
gB
gB
oL
Tx
gB
gB
gB
sY
lt
xQ
GL
CZ
"}
(7,1,1) = {"
Dd
Dd
gB
gB
gB
gB
gB
gB
gB
gB
gB
lt
gB
gB
lt
"}
(8,1,1) = {"
tS
lt
gB
gB
gB
gB
gB
gB
gB
gB
gB
lt
gB
gB
tn
"}
(9,1,1) = {"
lt
gB
gB
gB
gB
gB
gB
gB
gB
gB
xQ
tS
lt
lt
lt
"}
(10,1,1) = {"
lt
gB
gB
gB
gB
gB
gB
gB
gB
xQ
xQ
tS
og
Dd
sY
"}
(11,1,1) = {"
lt
lt
gB
gB
gB
gB
gB
lt
lt
lt
xQ
gB
lt
Dd
Dd
"}
(12,1,1) = {"
sY
tS
lt
gB
gB
oL
Tx
lt
tS
lt
gB
gB
gB
Dd
Dd
"}
(13,1,1) = {"
lt
gB
lt
Dd
gB
oL
lt
tS
lt
gB
gB
gB
gB
gB
Dd
"}
(14,1,1) = {"
lt
gB
gB
lt
lt
lt
lt
Dd
lt
gB
gB
lt
lt
aJ
lt
"}
(15,1,1) = {"
tS
gB
gB
lt
ab
wj
Dd
Dd
Dd
lt
lt
lt
lt
tS
lt
"}

(1,1,2) = {"
sX
sX
sX
sX
sX
sX
sX
sX
sX
sX
sX
sX
gB
sX
sX
"}
(2,1,2) = {"
sX
sX
gB
gB
sX
sX
sX
sX
sX
sX
og
lt
gB
gB
sX
"}
(3,1,2) = {"
sX
gB
gB
gB
sX
sX
lt
xQ
UM
UM
tS
xQ
gB
gB
sX
"}
(4,1,2) = {"
sX
sX
sX
sX
sX
sX
lt
lt
sX
sX
sX
xQ
xQ
lt
sX
"}
(5,1,2) = {"
sX
sX
sX
sX
lt
sX
UM
sX
sX
sX
sX
sX
UM
sX
sX
"}
(6,1,2) = {"
sX
sX
sX
tS
og
sX
UM
gB
gB
gB
sX
sX
UM
sX
sX
"}
(7,1,2) = {"
sX
sX
lt
xQ
xQ
lt
lt
gB
gB
gB
gB
sX
tS
lt
sX
"}
(8,1,2) = {"
sX
sX
lt
gB
gB
gB
aJ
gB
gB
gB
gB
sX
lt
xQ
sX
"}
(9,1,2) = {"
sX
gB
gB
gB
gB
gB
tS
lt
gB
gB
sX
sX
sX
sX
sX
"}
(10,1,2) = {"
sX
gB
gB
gB
gB
gB
lt
lt
lt
sX
sX
sX
sX
sX
sX
"}
(11,1,2) = {"
sX
sX
lt
lt
lt
lt
lt
sX
sX
sX
sX
tS
sX
sX
sX
"}
(12,1,2) = {"
sX
sX
UM
og
lt
sX
sX
sX
sX
sX
xQ
gB
lt
sX
sX
"}
(13,1,2) = {"
sX
lt
UM
sX
lt
sX
sX
sX
sX
gB
gB
gB
gB
aJ
sX
"}
(14,1,2) = {"
sX
lt
lt
sX
sX
sX
sX
sX
sX
gB
gB
sX
sX
sX
sX
"}
(15,1,2) = {"
sX
lt
lt
sX
sX
sX
sX
sX
sX
sX
sX
sX
sX
sX
sX
"}

(1,1,3) = {"
KT
KT
KT
KT
KT
KT
KT
KT
KT
KT
KT
KT
gB
KT
KT
"}
(2,1,3) = {"
KT
KT
lB
uu
KT
KT
KT
KT
KT
KT
KT
KT
gB
gB
KT
"}
(3,1,3) = {"
KT
lB
lB
lB
KT
KT
KT
KT
KT
KT
KT
KT
gB
uu
KT
"}
(4,1,3) = {"
KT
KT
KT
KT
KT
KT
KT
KT
KT
KT
KT
KT
KT
KT
KT
"}
(5,1,3) = {"
KT
KT
KT
KT
KT
KT
KT
KT
KT
KT
KT
KT
KT
KT
KT
"}
(6,1,3) = {"
KT
KT
KT
KT
KT
KT
KT
lB
lB
uu
KT
KT
KT
KT
KT
"}
(7,1,3) = {"
KT
KT
KT
KT
KT
KT
KT
lB
gB
gB
lB
KT
KT
KT
KT
"}
(8,1,3) = {"
KT
KT
KT
gB
gB
lB
KT
lB
gB
gB
lB
KT
KT
KT
KT
"}
(9,1,3) = {"
KT
lB
gB
gB
gB
lB
KT
KT
uu
lB
KT
KT
KT
KT
KT
"}
(10,1,3) = {"
KT
uu
lB
lB
lB
lB
KT
KT
KT
KT
KT
KT
KT
KT
KT
"}
(11,1,3) = {"
KT
KT
KT
KT
KT
KT
KT
KT
KT
KT
KT
KT
KT
KT
KT
"}
(12,1,3) = {"
KT
KT
KT
KT
KT
KT
KT
KT
KT
KT
KT
lB
KT
KT
KT
"}
(13,1,3) = {"
KT
KT
KT
KT
KT
KT
KT
KT
KT
lB
uu
lB
lB
KT
KT
"}
(14,1,3) = {"
KT
KT
KT
KT
KT
KT
KT
KT
KT
lB
lB
KT
KT
KT
KT
"}
(15,1,3) = {"
KT
KT
KT
KT
KT
KT
KT
KT
KT
KT
KT
KT
KT
KT
KT
"}

(1,1,4) = {"
KT
KT
KT
KT
KT
KT
KT
KT
KT
KT
KT
KT
lB
KT
KT
"}
(2,1,4) = {"
KT
KT
KT
KT
KT
KT
KT
KT
KT
KT
KT
KT
uu
lB
KT
"}
(3,1,4) = {"
KT
KT
KT
KT
KT
KT
KT
KT
KT
KT
KT
KT
lB
KT
KT
"}
(4,1,4) = {"
KT
KT
KT
KT
KT
KT
KT
KT
KT
KT
KT
KT
KT
KT
KT
"}
(5,1,4) = {"
KT
KT
KT
KT
KT
KT
KT
KT
KT
KT
KT
KT
KT
KT
KT
"}
(6,1,4) = {"
KT
KT
KT
KT
KT
KT
KT
KT
KT
KT
KT
KT
KT
KT
KT
"}
(7,1,4) = {"
KT
KT
KT
KT
KT
KT
KT
KT
lB
uu
KT
KT
KT
KT
KT
"}
(8,1,4) = {"
KT
KT
KT
WJ
lB
KT
KT
KT
lB
WJ
KT
KT
KT
KT
KT
"}
(9,1,4) = {"
KT
KT
lB
uu
lB
KT
KT
KT
KT
KT
KT
KT
KT
KT
KT
"}
(10,1,4) = {"
KT
KT
KT
KT
KT
KT
KT
KT
KT
KT
KT
KT
KT
KT
KT
"}
(11,1,4) = {"
KT
KT
KT
KT
KT
KT
KT
KT
KT
KT
KT
KT
KT
KT
KT
"}
(12,1,4) = {"
KT
KT
KT
KT
KT
KT
KT
KT
KT
KT
KT
KT
KT
KT
KT
"}
(13,1,4) = {"
KT
KT
KT
KT
KT
KT
KT
KT
KT
KT
KT
KT
KT
KT
KT
"}
(14,1,4) = {"
KT
KT
KT
KT
KT
KT
KT
KT
KT
KT
KT
KT
KT
KT
KT
"}
(15,1,4) = {"
KT
KT
KT
KT
KT
KT
KT
KT
KT
KT
KT
KT
KT
KT
KT
"}
