//MAP CONVERTED BY dmm2tgm.py THIS HEADER COMMENT PREVENTS RECONVERSION, DO NOT REMOVE
"aJ" = (
/obj/structure/flora/roguetree/stump/burnt,
/turf/open/floor/rogue/grassyel,
/area/rogue/outdoors/mountains)
"dE" = (
/obj/structure/flora/roguetree/burnt,
/turf/open/floor/rogue/grassyel,
/area/rogue/outdoors/mountains)
"ht" = (
/obj/item/natural/rock,
/turf/open/floor/rogue/naturalstone,
/area/rogue/outdoors/mountains)
"jP" = (
/obj/effect/spawner/lootdrop/roguetown/dungeon/tools,
/obj/effect/roofing_helper/twig,
/turf/open/floor/rogue/ruinedwood/turned,
/area/rogue/indoors/shelter/mountains)
"lt" = (
/obj/machinery/light/rogue/torchholder/r{
	dir = 4
	},
/obj/effect/roofing_helper/twig,
/turf/open/floor/rogue/ruinedwood/turned,
/area/rogue/indoors/shelter/mountains)
"pj" = (
/obj/item/natural/bone,
/obj/effect/roofing_helper/twig,
/turf/open/floor/rogue/ruinedwood/turned,
/area/rogue/indoors/shelter/mountains)
"qC" = (
/obj/item/natural/rock,
/turf/open/floor/rogue/grassyel,
/area/rogue/outdoors/mountains)
"qK" = (
/turf/open/floor/rogue/grassyel,
/area/rogue/outdoors/mountains)
"rN" = (
/obj/structure/table/wood{
	icon_state = "longtable"
	},
/obj/item/bait/bloody,
/obj/item/bait/bloody,
/obj/item/bait/bloody,
/obj/item/bait/bloody,
/obj/item/bait/bloody,
/obj/item/bait/bloody,
/obj/item/bait{
	pixel_x = 17
	},
/obj/item/bait{
	pixel_x = 17
	},
/obj/item/bait{
	pixel_x = 17
	},
/obj/item/bait{
	pixel_x = 17
	},
/obj/structure/rack/rogue/shelf/big,
/obj/effect/roofing_helper/twig,
/turf/open/floor/rogue/ruinedwood/turned,
/area/rogue/indoors/shelter/mountains)
"sX" = (
/turf/open/floor/rogue/dirt/road,
/area/rogue/outdoors/mountains)
"uf" = (
/obj/machinery/light/rogue/torchholder/r,
/turf/open/floor/rogue/grassyel,
/area/rogue/outdoors/mountains)
"uj" = (
/obj/structure/flora/roguegrass,
/turf/open/floor/rogue/dirt/road,
/area/rogue/outdoors/mountains)
"xQ" = (
/obj/structure/table/wood{
	dir = 1;
	icon_state = "longtable"
	},
/obj/item/bait/sweet,
/obj/item/bait/sweet,
/obj/item/bait/sweet,
/obj/item/bait/sweet,
/obj/item/bait/sweet,
/obj/effect/roofing_helper/twig,
/turf/open/floor/rogue/ruinedwood/turned,
/area/rogue/indoors/shelter/mountains)
"yr" = (
/turf/open/floor/rogue/naturalstone,
/area/rogue/outdoors/mountains)
"AW" = (
/obj/effect/roofing_helper/twig,
/turf/open/floor/rogue/ruinedwood/turned,
/area/rogue/indoors/shelter/mountains)
"Cy" = (
/obj/structure/flora/roguegrass,
/turf/open/floor/rogue/grassyel,
/area/rogue/outdoors/mountains)
"Dc" = (
/obj/structure/chair/bench{
	pixel_y = 16
	},
/turf/open/floor/rogue/dirt/road,
/area/rogue/outdoors/mountains)
"Dd" = (
/obj/structure/flora/roguetree/burnt,
/turf/open/floor/rogue/dirt/road,
/area/rogue/outdoors/mountains)
"FI" = (
/obj/structure/bed/rogue/shit{
	name = "makeshift bed"
	},
/obj/effect/roofing_helper/twig,
/turf/open/floor/rogue/ruinedwood/turned,
/area/rogue/indoors/shelter/mountains)
"GL" = (
/obj/structure/flora/roguegrass,
/turf/open/floor/rogue/naturalstone,
/area/rogue/outdoors/mountains)
"Jh" = (
/obj/structure/roguewindow/openclose{
	dir = 8
	},
/obj/effect/roofing_helper/twig,
/turf/open/floor/rogue/ruinedwood/turned,
/area/rogue/indoors/shelter/mountains)
"KD" = (
/obj/structure/roguewindow/openclose{
	dir = 1
	},
/obj/effect/roofing_helper/twig,
/turf/open/floor/rogue/ruinedwood/turned,
/area/rogue/indoors/shelter/mountains)
"KT" = (
/obj/machinery/light/rogue/torchholder/c,
/turf/open/floor/rogue/dirt/road,
/area/rogue/outdoors/mountains)
"VW" = (
/obj/structure/flora/roguetree/stump/log,
/turf/open/floor/rogue/dirt/road,
/area/rogue/outdoors/mountains)
"Wf" = (
/obj/effect/roofing_helper/twig,
/turf/closed/wall/mineral/rogue/wooddark,
/area/rogue/indoors/shelter/mountains)
"Ze" = (
/obj/structure/mineral_door/wood/deadbolt{
	dir = 1
	},
/obj/effect/roofing_helper/twig,
/turf/open/floor/rogue/ruinedwood/turned,
/area/rogue/indoors/shelter/mountains)

(1,1,1) = {"
qK
sX
qK
qK
qK
qK
qK
qK
qK
qK
qK
qK
qK
qK
qK
"}
(2,1,1) = {"
qK
qK
yr
ht
qK
qK
qK
sX
Cy
sX
sX
sX
aJ
qK
qK
"}
(3,1,1) = {"
qK
qK
uj
qK
qK
dE
yr
yr
yr
sX
qK
sX
uj
Cy
qC
"}
(4,1,1) = {"
qK
sX
uj
qK
qK
qK
qK
Cy
Cy
qK
qK
yr
sX
qK
qK
"}
(5,1,1) = {"
qK
sX
sX
qK
Cy
sX
uf
qK
Cy
Cy
qK
Cy
GL
VW
qK
"}
(6,1,1) = {"
qK
sX
qK
qK
uj
Wf
Wf
Wf
Wf
Wf
Wf
qK
Cy
sX
qK
"}
(7,1,1) = {"
Cy
qK
yr
qK
sX
Wf
rN
AW
lt
pj
Ze
qK
yr
sX
qK
"}
(8,1,1) = {"
Cy
qK
yr
sX
sX
Wf
xQ
jP
AW
FI
Wf
Dc
yr
sX
sX
"}
(9,1,1) = {"
qK
qK
qK
uj
qK
Wf
AW
AW
AW
FI
KD
qK
yr
sX
qK
"}
(10,1,1) = {"
qK
yr
sX
sX
qK
Wf
Jh
Wf
Wf
Wf
Wf
KT
Cy
qK
Cy
"}
(11,1,1) = {"
qK
yr
yr
sX
sX
qK
qK
qK
sX
sX
sX
VW
Cy
qC
Cy
"}
(12,1,1) = {"
qK
qK
qK
yr
Dd
sX
qK
sX
sX
sX
GL
yr
qK
qK
qK
"}
(13,1,1) = {"
qK
qK
qK
qK
yr
sX
sX
uj
qK
sX
qK
qK
qK
dE
sX
"}
(14,1,1) = {"
qK
qK
qK
Cy
yr
yr
sX
uj
qK
Cy
qK
qK
sX
sX
sX
"}
(15,1,1) = {"
qK
qC
qK
qK
qK
qK
uj
qK
qK
Cy
qK
sX
sX
sX
qK
"}
