//MAP CONVERTED BY dmm2tgm.py THIS HEADER COMMENT PREVENTS RECONVERSION, DO NOT REMOVE
"a" = (
/obj/structure/flora/roguetree/burnt,
/turf/open/floor/rogue/grassyel,
/area/rogue/outdoors/mountains)
"c" = (
/mob/living/carbon/human/species/goblin/npc/ambush/cave,
/turf/open/floor/rogue/dirt/road,
/area/rogue/indoors/shelter)
"h" = (
/obj/structure/flora/roguetree/stump/log,
/turf/open/floor/rogue/grassyel,
/area/rogue/outdoors/mountains)
"j" = (
/turf/closed/wall/mineral/rogue/tent{
	dir = 8
	},
/area/rogue/indoors/shelter)
"l" = (
/obj/structure/flora/roguetree/stump,
/turf/open/floor/rogue/grassyel,
/area/rogue/outdoors/mountains)
"m" = (
/turf/closed/wall/mineral/rogue/tent{
	dir = 1
	},
/area/rogue/indoors/shelter)
"n" = (
/obj/machinery/light/rogue/campfire,
/turf/open/floor/rogue/dirt/road,
/area/rogue/outdoors/mountains)
"o" = (
/obj/structure/flora/roguegrass,
/turf/open/floor/rogue/grassyel,
/area/rogue/outdoors/mountains)
"t" = (
/obj/item/natural/stone,
/turf/open/floor/rogue/grassyel,
/area/rogue/outdoors/mountains)
"z" = (
/turf/closed/wall/mineral/rogue/tent{
	dir = 4
	},
/area/rogue/indoors/shelter)
"D" = (
/obj/structure/toilet,
/mob/living/carbon/human/species/goblin/npc/ambush/cave,
/turf/open/floor/rogue/dirt,
/area/rogue/indoors/shelter)
"F" = (
/obj/structure/bed/rogue/inn/hay,
/mob/living/carbon/human/species/goblin/npc/ambush/cave,
/turf/open/floor/rogue/dirt/road,
/area/rogue/indoors/shelter)
"G" = (
/obj/item/roguebin/water/gross,
/obj/item/reagent_containers/glass/bucket/wooden{
	pixel_x = 14;
	pixel_y = -10
	},
/turf/open/floor/rogue/naturalstone,
/area/rogue/outdoors/mountains)
"J" = (
/turf/open/floor/rogue/naturalstone,
/area/rogue/outdoors/mountains)
"K" = (
/turf/open/floor/rogue/dirt/road,
/area/rogue/outdoors/mountains)
"L" = (
/obj/effect/decal/remains/human,
/turf/open/floor/rogue/dirt/road,
/area/rogue/indoors/shelter)
"M" = (
/obj/item/roguebin/water/gross,
/obj/structure/flora/roguegrass,
/turf/open/floor/rogue/grassyel,
/area/rogue/outdoors/mountains)
"O" = (
/obj/structure/roguetent,
/turf/open/floor/rogue/dirt/road,
/area/rogue/indoors/shelter)
"P" = (
/turf/open/floor/rogue/grassyel,
/area/rogue/outdoors/mountains)
"Q" = (
/obj/structure/flora/roguegrass,
/turf/open/floor/rogue/naturalstone,
/area/rogue/outdoors/mountains)
"R" = (
/obj/structure/closet/crate/chest/old_crate,
/obj/effect/spawner/lootdrop/roguetown/dungeon/weapons,
/turf/open/floor/rogue/dirt/road,
/area/rogue/indoors/shelter)
"S" = (
/obj/structure/flora/roguetree/stump/burnt,
/turf/open/floor/rogue/grassyel,
/area/rogue/outdoors/mountains)
"U" = (
/turf/closed/wall/mineral/rogue/tent,
/area/rogue/indoors/shelter)
"Y" = (
/obj/structure/bed/rogue/inn/hay,
/turf/open/floor/rogue/dirt/road,
/area/rogue/indoors/shelter)
"Z" = (
/turf/closed/wall/mineral/rogue/wooddark,
/area/rogue/indoors/shelter)

(1,1,1) = {"
o
o
o
o
P
o
P
P
S
P
"}
(2,1,1) = {"
Z
j
j
Z
P
P
t
P
P
P
"}
(3,1,1) = {"
m
R
F
U
J
J
K
K
o
P
"}
(4,1,1) = {"
O
c
L
O
P
n
K
P
P
P
"}
(5,1,1) = {"
m
Y
c
U
P
P
K
K
P
l
"}
(6,1,1) = {"
Z
z
z
Z
Q
P
P
P
h
P
"}
(7,1,1) = {"
o
M
G
P
t
P
Z
j
Z
P
"}
(8,1,1) = {"
P
J
P
P
o
o
m
D
O
P
"}
(9,1,1) = {"
o
P
P
a
P
o
Z
z
Z
P
"}
(10,1,1) = {"
o
o
o
P
P
P
P
P
P
t
"}
