//MAP CONVERTED BY dmm2tgm.py THIS HEADER COMMENT PREVENTS RECONVERSION, DO NOT REMOVE
"a" = (
/obj/item/natural/stone,
/turf/open/floor/rogue/grassyel,
/area/rogue/outdoors/woods)
"b" = (
/obj/item/flashlight/flare/torch/lantern,
/obj/structure/table/wood{
	dir = 4;
	icon_state = "longtable"
	},
/obj/item/natural/bundle/stick,
/obj/item/candle/yellow{
	pixel_x = -11;
	pixel_y = 5
	},
/obj/item/natural/bundle/silk,
/obj/item/natural/fibers,
/obj/item/natural/fibers,
/obj/effect/roofing_helper,
/turf/open/floor/rogue/twig,
/area/rogue/indoors/shelter/woods)
"c" = (
/obj/item/natural/stone,
/turf/open/floor/rogue/naturalstone,
/area/rogue/outdoors/woods)
"d" = (
/obj/structure/closet/crate/chest/crate,
/obj/machinery/light/rogue/torchholder/l,
/obj/item/natural/bundle/stick,
/obj/item/natural/bundle/stick,
/obj/item/natural/bundle/stick,
/obj/item/candle/yellow,
/obj/item/candle/yellow,
/obj/item/candle/yellow,
/obj/item/reagent_containers/food/snacks/rogue/meat/coppiette,
/obj/item/reagent_containers/food/snacks/rogue/meat/coppiette,
/obj/effect/roofing_helper,
/turf/open/floor/rogue/dirt/road,
/area/rogue/indoors/shelter/woods)
"e" = (
/obj/item/natural/stone,
/turf/open/floor/rogue/dirt,
/area/rogue/outdoors/woods)
"g" = (
/obj/structure/flora/roguetree/stump/burnt,
/turf/open/floor/rogue/grassyel,
/area/rogue/outdoors/woods)
"i" = (
/obj/structure/table/wood{
	icon_state = "longtable_mid"
	},
/obj/item/flint,
/obj/effect/roofing_helper,
/obj/item/rogueweapon/spear/stone,
/turf/open/floor/rogue/twig,
/area/rogue/indoors/shelter/woods)
"k" = (
/obj/structure/flora/roguegrass,
/turf/open/floor/rogue/grassyel,
/area/rogue/outdoors/woods)
"l" = (
/obj/structure/bed/rogue/inn/hay,
/obj/effect/roofing_helper,
/obj/effect/spawner/lootdrop/roguetown/sewers,
/turf/open/floor/rogue/twig,
/area/rogue/indoors/shelter/woods)
"m" = (
/obj/effect/roofing_helper,
/turf/open/floor/rogue/twig,
/area/rogue/indoors/shelter/woods)
"n" = (
/obj/item/paper/scroll,
/obj/item/natural/feather,
/obj/structure/table/wood{
	icon_state = "tablewood1"
	},
/obj/machinery/light/rogue/torchholder/r,
/obj/item/paper{
	pixel_x = 2;
	pixel_y = 2
	},
/obj/effect/roofing_helper,
/turf/open/floor/rogue/twig,
/area/rogue/indoors/shelter/woods)
"r" = (
/obj/effect/roofing_helper,
/turf/open/floor/rogue/dirt/road,
/area/rogue/indoors/shelter/woods)
"u" = (
/obj/structure/roguerock,
/turf/open/floor/rogue/naturalstone,
/area/rogue/outdoors/woods)
"z" = (
/obj/item/natural/rock/silver,
/turf/open/floor/rogue/naturalstone,
/area/rogue/outdoors/woods)
"B" = (
/obj/item/natural/rock/iron,
/turf/open/floor/rogue/naturalstone,
/area/rogue/outdoors/woods)
"D" = (
/obj/structure/handcart{
	dir = 8
	},
/obj/effect/roofing_helper,
/turf/open/floor/rogue/dirt/road,
/area/rogue/indoors/shelter/woods)
"E" = (
/turf/open/floor/rogue/grassyel,
/area/rogue/outdoors/woods)
"F" = (
/obj/structure/flora/roguetree/stump/log,
/turf/open/floor/rogue/grassyel,
/area/rogue/outdoors/woods)
"H" = (
/turf/open/floor/rogue/naturalstone,
/area/rogue/outdoors/woods)
"K" = (
/turf/open/floor/rogue/dirt/road,
/area/rogue/outdoors/woods)
"N" = (
/obj/effect/roofing_helper,
/turf/closed/wall/mineral/rogue/wooddark,
/area/rogue/indoors/shelter/woods)
"Q" = (
/obj/structure/roguetent,
/obj/effect/roofing_helper,
/turf/open/floor/rogue/dirt/road,
/area/rogue/indoors/shelter/woods)
"S" = (
/obj/structure/closet/crate/chest/crate,
/obj/item/rogueweapon/shovel/small{
	pixel_x = 6
	},
/obj/item/rogueweapon/stoneaxe/woodcut,
/obj/item/rogueweapon/shovel,
/obj/item/rogueweapon/pick,
/obj/item/rogueweapon/pick,
/obj/effect/roofing_helper,
/turf/open/floor/rogue/dirt/road,
/area/rogue/indoors/shelter/woods)
"T" = (
/obj/structure/flora/roguetree/stump/log,
/turf/open/floor/rogue/dirt,
/area/rogue/outdoors/woods)
"U" = (
/obj/structure/roguetent,
/obj/effect/roofing_helper,
/turf/open/floor/rogue/twig,
/area/rogue/indoors/shelter/woods)
"V" = (
/turf/open/floor/rogue/dirt,
/area/rogue/outdoors/woods)
"W" = (
/obj/structure/roguetent,
/obj/effect/roofing_helper,
/turf/open/floor/rogue/dirt,
/area/rogue/indoors/shelter/woods)
"X" = (
/obj/structure/flora/roguegrass/bush,
/turf/open/floor/rogue/grassyel,
/area/rogue/outdoors/woods)
"Y" = (
/obj/machinery/light/rogue/torchholder/r,
/obj/item/roguebin/water,
/obj/effect/roofing_helper,
/turf/open/floor/rogue/dirt/road,
/area/rogue/indoors/shelter/woods)
"Z" = (
/obj/item/natural/rock/tin,
/turf/open/floor/rogue/naturalstone,
/area/rogue/outdoors/woods)

(1,1,1) = {"
V
V
E
X
E
H
H
H
E
g
"}
(2,1,1) = {"
N
N
N
N
N
N
N
u
H
F
"}
(3,1,1) = {"
N
b
i
N
d
S
N
H
c
H
"}
(4,1,1) = {"
N
m
m
U
r
r
Q
K
H
u
"}
(5,1,1) = {"
N
m
m
U
r
r
W
K
K
X
"}
(6,1,1) = {"
N
l
n
N
Y
D
N
V
V
E
"}
(7,1,1) = {"
N
N
N
N
N
N
N
e
V
V
"}
(8,1,1) = {"
k
H
Z
H
B
H
V
T
k
E
"}
(9,1,1) = {"
E
E
u
H
H
z
c
X
E
E
"}
(10,1,1) = {"
E
E
E
H
H
E
a
E
V
V
"}
