//MAP CONVERTED BY dmm2tgm.py THIS HEADER COMMENT PREVENTS RECONVERSION, DO NOT REMOVE
"CW" = (
/turf/open/floor/rogue/naturalstone,
/area/rogue/outdoors/woods/churchfort/basement)
"KC" = (
/turf/open/floor/rogue/metal/barograte,
/area/rogue/outdoors/woods/churchfort/basement)

(1,1,1) = {"
CW
CW
CW
CW
CW
CW
CW
CW
KC
CW
CW
KC
KC
CW
KC
"}
(2,1,1) = {"
CW
CW
CW
CW
CW
CW
CW
KC
CW
CW
KC
CW
KC
CW
KC
"}
(3,1,1) = {"
CW
CW
CW
CW
CW
CW
CW
KC
CW
KC
KC
CW
KC
CW
KC
"}
(4,1,1) = {"
CW
CW
CW
CW
CW
CW
CW
CW
KC
KC
CW
CW
KC
CW
KC
"}
(5,1,1) = {"
CW
CW
CW
CW
CW
CW
CW
CW
CW
CW
CW
CW
CW
CW
KC
"}
(6,1,1) = {"
CW
CW
CW
CW
CW
CW
CW
CW
CW
KC
KC
KC
CW
CW
KC
"}
(7,1,1) = {"
CW
CW
CW
CW
CW
CW
CW
CW
CW
CW
CW
KC
KC
CW
KC
"}
(8,1,1) = {"
CW
CW
CW
CW
CW
CW
CW
CW
CW
KC
KC
KC
CW
CW
KC
"}
(9,1,1) = {"
CW
CW
CW
CW
CW
CW
CW
CW
CW
CW
CW
CW
CW
CW
KC
"}
(10,1,1) = {"
CW
CW
CW
CW
CW
CW
CW
CW
KC
CW
CW
KC
KC
CW
KC
"}
(11,1,1) = {"
CW
CW
CW
CW
CW
CW
CW
KC
CW
CW
KC
CW
KC
CW
KC
"}
(12,1,1) = {"
CW
CW
CW
CW
CW
CW
CW
KC
CW
KC
KC
CW
KC
CW
KC
"}
(13,1,1) = {"
CW
CW
CW
CW
CW
CW
CW
CW
KC
KC
CW
CW
KC
CW
KC
"}
(14,1,1) = {"
CW
CW
CW
CW
CW
CW
CW
CW
CW
CW
CW
CW
CW
CW
KC
"}
(15,1,1) = {"
KC
KC
KC
KC
KC
KC
KC
KC
KC
KC
KC
KC
KC
KC
KC
"}
