//MAP CONVERTED BY dmm2tgm.py THIS HEADER COMMENT PREVENTS RECONVERSION, DO NOT REMOVE
"cs" = (
/obj/effect/decal/cleanable/blood/gibs/up,
/obj/effect/decal/cleanable/blood,
/turf/open/floor/rogue/underworld/road,
/area/rogue/outdoors/woods/churchfort/basement)
"cO" = (
/obj/effect/decal/cleanable/blood/gibs,
/obj/effect/decal/cleanable/blood,
/turf/open/floor/rogue/underworld/road,
/area/rogue/outdoors/woods/churchfort/basement)
"eF" = (
/obj/item/natural/stone,
/turf/open/floor/rogue/naturalstone,
/area/rogue/outdoors/woods/churchfort/basement)
"eI" = (
/obj/effect/decal/cleanable/blood/gibs,
/obj/effect/decal/cleanable/blood/gibs/up,
/obj/effect/decal/cleanable/blood/tracks,
/obj/effect/decal/cleanable/blood,
/turf/open/floor/rogue/naturalstone,
/area/rogue/outdoors/woods/churchfort/basement)
"fW" = (
/turf/closed/mineral/rogue/bedrock,
/area/rogue/outdoors/woods/churchfort/basement)
"hT" = (
/obj/structure/fluff/walldeco/katholikos_banner/gani{
	pixel_x = 33
	},
/turf/open/floor/rogue/blocks/green,
/area/rogue/outdoors/woods/churchfort/basement)
"hU" = (
/obj/effect/decal/cleanable/blood/gibs,
/obj/effect/decal/cleanable/blood,
/mob/living/simple_animal/hostile/retaliate/rogue/fiend_lesser/shambler,
/turf/open/floor/rogue/naturalstone,
/area/rogue/outdoors/woods/churchfort/basement)
"hV" = (
/obj/effect/decal/cleanable/blood/tracks{
	dir = 4
	},
/turf/open/floor/rogue/underworld/road,
/area/rogue/outdoors/woods/churchfort/basement)
"hY" = (
/mob/living/simple_animal/hostile/retaliate/rogue/fiend_lesser/cacophony,
/turf/open/floor/rogue/naturalstone,
/area/rogue/outdoors/woods/churchfort/basement)
"iG" = (
/obj/effect/decal/cleanable/blood/tracks{
	dir = 4
	},
/turf/open/floor/rogue/naturalstone,
/area/rogue/outdoors/woods/churchfort/basement)
"jE" = (
/turf/closed/wall/mineral/rogue/stone/red_moss,
/area/rogue/outdoors/woods/churchfort/basement)
"kg" = (
/obj/effect/decal/cleanable/blood/gibs/down,
/obj/effect/decal/cleanable/blood,
/turf/open/floor/rogue/naturalstone,
/area/rogue/outdoors/woods/churchfort/basement)
"lY" = (
/obj/effect/decal/cleanable/blood/tracks{
	dir = 10
	},
/turf/open/floor/rogue/naturalstone,
/area/rogue/outdoors/woods/churchfort/basement)
"mj" = (
/mob/living/simple_animal/hostile/retaliate/rogue/fiend_lesser/shambler,
/turf/open/floor/rogue/underworld/road,
/area/rogue/outdoors/woods/churchfort/basement)
"tk" = (
/obj/effect/decal/cleanable/blood/tracks,
/turf/open/floor/rogue/naturalstone,
/area/rogue/outdoors/woods/churchfort/basement)
"va" = (
/obj/item/natural/stone,
/turf/open/floor/rogue/volcanic,
/area/rogue/outdoors/woods/churchfort/basement)
"vW" = (
/turf/closed/wall/mineral/rogue/stone,
/area/rogue/outdoors/woods/churchfort/basement)
"xJ" = (
/obj/effect/decal/cleanable/blood/gibs,
/obj/effect/decal/cleanable/blood/gibs/body,
/obj/effect/decal/cleanable/blood,
/turf/open/floor/rogue/naturalstone,
/area/rogue/outdoors/woods/churchfort/basement)
"zu" = (
/turf/open/floor/rogue/underworld/road,
/area/rogue/outdoors/woods/churchfort/basement)
"CG" = (
/mob/living/simple_animal/hostile/retaliate/rogue/fiend_lesser,
/turf/open/floor/rogue/naturalstone,
/area/rogue/outdoors/woods/churchfort/basement)
"CW" = (
/turf/open/floor/rogue/naturalstone,
/area/rogue/outdoors/woods/churchfort/basement)
"Kl" = (
/turf/open/floor/rogue/blocks/green,
/area/rogue/outdoors/woods/churchfort/basement)
"KC" = (
/turf/closed/mineral/random/rogue,
/area/rogue/outdoors/woods/churchfort/basement)
"Nb" = (
/obj/item/natural/rock,
/turf/open/floor/rogue/naturalstone,
/area/rogue/outdoors/woods/churchfort/basement)
"ND" = (
/mob/living/simple_animal/hostile/retaliate/rogue/fiend_lesser/shambler,
/turf/open/floor/rogue/naturalstone,
/area/rogue/outdoors/woods/churchfort/basement)
"NZ" = (
/mob/living/simple_animal/hostile/retaliate/rogue/fiend_lesser,
/obj/item/natural/rock,
/turf/open/floor/rogue/naturalstone,
/area/rogue/outdoors/woods/churchfort/basement)
"Ol" = (
/obj/effect/decal/cleanable/blood/gibs,
/obj/effect/decal/cleanable/blood/gibs/core,
/obj/effect/decal/cleanable/blood,
/turf/open/floor/rogue/naturalstone,
/area/rogue/outdoors/woods/churchfort/basement)
"Ss" = (
/obj/structure/fluff/walldeco/katholikos_banner/mjallidhorn{
	pixel_x = 33
	},
/turf/open/floor/rogue/blocks/green,
/area/rogue/outdoors/woods/churchfort/basement)
"SC" = (
/obj/structure/stairs/stone,
/turf/open/floor/rogue/blocks/green,
/area/rogue/outdoors/woods/churchfort/basement)
"SD" = (
/obj/effect/decal/cleanable/blood/gibs/limb,
/obj/effect/decal/cleanable/blood,
/mob/living/simple_animal/hostile/retaliate/rogue/fiend_lesser/dragon,
/turf/open/floor/rogue/naturalstone,
/area/rogue/outdoors/woods/churchfort/basement)
"Uq" = (
/obj/effect/decal/cleanable/blood/gibs/core,
/obj/effect/decal/cleanable/blood,
/turf/open/floor/rogue/naturalstone,
/area/rogue/outdoors/woods/churchfort/basement)
"VI" = (
/obj/machinery/light/rogue/wallfire/candle/r,
/turf/open/floor/rogue/cobble,
/area/rogue/outdoors/woods/churchfort/basement)
"XE" = (
/obj/effect/decal/cleanable/blood/tracks{
	dir = 5
	},
/turf/open/floor/rogue/naturalstone,
/area/rogue/outdoors/woods/churchfort/basement)
"XZ" = (
/obj/effect/decal/cleanable/blood/tracks,
/mob/living/simple_animal/hostile/retaliate/rogue/fiend_lesser/cacophony,
/turf/open/floor/rogue/naturalstone,
/area/rogue/outdoors/woods/churchfort/basement)
"Zv" = (
/obj/item/roguegem/random,
/turf/open/floor/rogue/volcanic,
/area/rogue/outdoors/woods/churchfort/basement)

(1,1,1) = {"
hT
VI
Ss
Kl
SC
jE
KC
KC
KC
KC
KC
KC
KC
KC
vW
"}
(2,1,1) = {"
vW
jE
jE
jE
vW
vW
KC
KC
KC
KC
KC
KC
KC
KC
KC
"}
(3,1,1) = {"
KC
KC
KC
KC
KC
KC
KC
KC
KC
KC
KC
KC
KC
KC
KC
"}
(4,1,1) = {"
fW
fW
fW
fW
fW
fW
KC
KC
KC
KC
KC
KC
KC
KC
KC
"}
(5,1,1) = {"
fW
Nb
fW
CG
CW
fW
fW
fW
KC
KC
KC
KC
KC
KC
KC
"}
(6,1,1) = {"
lY
CW
CW
CW
eF
Ol
CG
fW
fW
KC
KC
KC
KC
KC
KC
"}
(7,1,1) = {"
XE
tk
eI
tk
XZ
lY
CW
CW
fW
KC
KC
KC
KC
KC
KC
"}
(8,1,1) = {"
CW
CW
CG
Nb
CW
XE
lY
Nb
fW
fW
KC
KC
KC
KC
KC
"}
(9,1,1) = {"
fW
CW
CW
fW
fW
CG
XE
lY
xJ
fW
KC
KC
KC
KC
KC
"}
(10,1,1) = {"
fW
CW
CW
fW
fW
fW
eF
iG
CW
fW
KC
KC
KC
KC
KC
"}
(11,1,1) = {"
fW
NZ
CW
eF
fW
fW
fW
XE
lY
fW
fW
KC
KC
KC
KC
"}
(12,1,1) = {"
fW
fW
zu
hY
zu
fW
fW
CW
iG
Nb
fW
KC
KC
KC
KC
"}
(13,1,1) = {"
KC
fW
CW
CW
zu
CW
cO
ND
hV
hU
fW
fW
KC
KC
KC
"}
(14,1,1) = {"
KC
fW
fW
fW
Nb
mj
zu
cs
Uq
kg
zu
fW
KC
KC
KC
"}
(15,1,1) = {"
KC
KC
KC
fW
fW
fW
fW
va
SD
zu
Zv
fW
KC
KC
KC
"}
