//MAP CONVERTED BY dmm2tgm.py THIS HEADER COMMENT PREVENTS RECONVERSION, DO NOT REMOVE
"ai" = (
/turf/open/floor/rogue/churchrough,
/area/rogue/under/cave)
"ax" = (
/obj/structure/table/wood,
/obj/item/reagent_containers/glass/mortar,
/obj/item/pestle,
/turf/open/floor/rogue/churchrough,
/area/rogue/under/cave)
"cz" = (
/obj/structure/closet/crate/chest/crate,
/obj/effect/decal/cleanable/dirt/dust,
/turf/open/floor/rogue/churchrough,
/area/rogue/under/cave)
"fs" = (
/obj/structure/fluff/alch,
/turf/open/floor/rogue/churchrough,
/area/rogue/under/cave)
"jp" = (
/obj/effect/decal/cleanable/dirt,
/turf/open/floor/rogue/churchrough,
/area/rogue/under/cave)
"jL" = (
/obj/structure/roguetent,
/turf/open/floor/rogue/churchbrick,
/area/rogue/under/cave)
"kA" = (
/obj/item/natural/stone,
/turf/open/floor/rogue/naturalstone,
/area/rogue/under/cave)
"kW" = (
/turf/open/floor/rogue/dirt,
/area/rogue/under/cave)
"mD" = (
/obj/structure/closet/crate/chest/crate,
/turf/open/floor/rogue/churchrough,
/area/rogue/under/cave)
"rN" = (
/turf/open/floor/rogue/naturalstone,
/area/rogue/under/cave)
"sg" = (
/obj/structure/closet/crate/chest/crate,
/turf/open/floor/rogue/churchbrick,
/area/rogue/under/cave)
"sk" = (
/obj/structure/table/wood,
/obj/item/rogueweapon/huntingknife/chefknife,
/obj/item/cooking/pan,
/turf/open/floor/rogue/churchrough,
/area/rogue/under/cave)
"uF" = (
/turf/open/floor/rogue/churchbrick,
/area/rogue/under/cave)
"uM" = (
/turf/closed/mineral/random/rogue,
/area/rogue/under/cave)
"xe" = (
/obj/structure/chair/wood/rogue/chair3{
	dir = 8
	},
/obj/effect/decal/cleanable/dirt/dust,
/turf/open/floor/rogue/churchrough,
/area/rogue/under/cave)
"zx" = (
/obj/structure/rack/rogue/shelf/biggest,
/obj/item/flashlight/flare/torch/lantern/bronzelamptern,
/turf/open/floor/rogue/churchrough,
/area/rogue/under/cave)
"BE" = (
/obj/structure/roguetent,
/obj/effect/decal/cleanable/dirt,
/turf/open/floor/rogue/churchbrick,
/area/rogue/under/cave)
"Dc" = (
/obj/structure/mineral_door/wood/deadbolt{
	dir = 1
	},
/obj/effect/decal/cleanable/dirt,
/turf/open/floor/rogue/churchrough,
/area/rogue/under/cave)
"DD" = (
/obj/structure/rack/rogue,
/turf/open/floor/rogue/churchrough,
/area/rogue/under/cave)
"Er" = (
/turf/closed/wall/mineral/rogue/decostone,
/area/rogue/under/cave)
"Fx" = (
/obj/structure/bookcase,
/turf/open/floor/rogue/churchrough,
/area/rogue/under/cave)
"FZ" = (
/obj/machinery/light/rogue/firebowl/standing/blue,
/turf/open/floor/rogue/churchbrick,
/area/rogue/under/cave)
"Ht" = (
/obj/effect/decal/cleanable/dirt/dust,
/turf/open/floor/rogue/churchrough,
/area/rogue/under/cave)
"HH" = (
/obj/item/storage/roguebag,
/turf/open/floor/rogue/churchrough,
/area/rogue/under/cave)
"If" = (
/obj/machinery/light/rogue/firebowl/standing/blue,
/turf/open/floor/rogue/churchrough,
/area/rogue/under/cave)
"IQ" = (
/obj/structure/chair/stool/rogue,
/turf/open/floor/rogue/churchrough,
/area/rogue/under/cave)
"MU" = (
/obj/structure/telescope,
/obj/effect/decal/cleanable/dirt,
/turf/open/floor/rogue/churchrough,
/area/rogue/under/cave)
"Pw" = (
/obj/structure/closet/crate/coffin,
/obj/effect/spawner/lootdrop/roguetown/dungeon/materials,
/obj/effect/spawner/lootdrop/roguetown/dungeon/clothing,
/turf/open/floor/rogue/dirt,
/area/rogue/under/cave)
"Qf" = (
/obj/item/roguebin/water,
/obj/effect/decal/cleanable/dirt,
/turf/open/floor/rogue/churchrough,
/area/rogue/under/cave)
"QY" = (
/obj/effect/spawner/trap,
/turf/open/floor/rogue/naturalstone,
/area/rogue/under/cave)
"RC" = (
/obj/structure/globe,
/turf/open/floor/rogue/churchrough,
/area/rogue/under/cave)
"Ut" = (
/obj/effect/decal/cleanable/dirt,
/turf/open/floor/rogue/churchbrick,
/area/rogue/under/cave)
"US" = (
/obj/structure/trap/skeleton,
/turf/open/floor/rogue/dirt,
/area/rogue/under/cave)
"VC" = (
/obj/structure/bookcase,
/turf/open/floor/rogue/churchbrick,
/area/rogue/under/cave)
"Yd" = (
/obj/structure/closet/crate/chest/neu_iron,
/turf/open/floor/rogue/churchrough,
/area/rogue/under/cave)
"YB" = (
/obj/item/natural/rock,
/turf/open/floor/rogue/naturalstone,
/area/rogue/under/cave)

(1,1,1) = {"
uM
uM
uM
rN
rN
rN
kA
uM
rN
rN
rN
rN
rN
uM
uM
"}
(2,1,1) = {"
uM
rN
rN
rN
uM
uM
uM
uM
uM
rN
uM
rN
rN
rN
uM
"}
(3,1,1) = {"
uM
rN
Er
Er
Er
Er
Er
Er
uM
uM
uM
QY
rN
rN
YB
"}
(4,1,1) = {"
YB
QY
Er
fs
xe
RC
Fx
Yd
Er
Er
Er
Er
rN
uM
rN
"}
(5,1,1) = {"
rN
uM
Er
ax
Ht
Ht
ai
MU
Er
VC
FZ
Er
rN
uM
rN
"}
(6,1,1) = {"
rN
uM
Er
sk
ai
Ht
HH
Qf
Er
uF
uF
Er
rN
YB
rN
"}
(7,1,1) = {"
rN
uM
Er
Er
Er
DD
ai
jp
Er
uF
uM
uM
uM
rN
rN
"}
(8,1,1) = {"
uM
uM
uM
uM
Er
zx
Ht
Ht
Er
uF
sg
Er
uM
uM
rN
"}
(9,1,1) = {"
uM
Pw
Ut
Ut
BE
ai
jp
Ht
Er
Ut
uF
Er
uM
rN
kA
"}
(10,1,1) = {"
uM
kW
kW
uM
Er
mD
ai
Ht
Dc
jp
uF
jL
rN
rN
QY
"}
(11,1,1) = {"
uM
US
YB
uM
Er
If
IQ
cz
Er
ai
Ut
uM
uM
rN
rN
"}
(12,1,1) = {"
uM
uM
uM
uM
uM
uM
uM
uM
uM
uM
uM
uM
uM
rN
YB
"}
(13,1,1) = {"
rN
uM
uM
uM
uM
uM
uM
uM
uM
uM
uM
rN
rN
rN
rN
"}
(14,1,1) = {"
rN
rN
uM
uM
rN
rN
rN
uM
uM
uM
uM
rN
kA
rN
uM
"}
(15,1,1) = {"
uM
rN
rN
rN
rN
uM
rN
rN
kA
rN
rN
QY
rN
kA
uM
"}
