//MAP CONVERTED BY dmm2tgm.py THIS HEADER COMMENT PREVENTS RECONVERSION, DO NOT REMOVE
"kA" = (
/obj/item/natural/stone,
/turf/open/floor/rogue/naturalstone,
/area/rogue/under/cave)
"rN" = (
/turf/open/floor/rogue/naturalstone,
/area/rogue/under/cave)
"uM" = (
/turf/closed/mineral/random/rogue,
/area/rogue/under/cave)
"YB" = (
/obj/item/natural/rock,
/turf/open/floor/rogue/naturalstone,
/area/rogue/under/cave)

(1,1,1) = {"
uM
uM
uM
rN
rN
rN
kA
rN
rN
rN
rN
rN
rN
uM
uM
"}
(2,1,1) = {"
uM
uM
rN
rN
rN
rN
rN
rN
rN
rN
rN
rN
rN
rN
uM
"}
(3,1,1) = {"
uM
rN
rN
rN
uM
rN
rN
rN
rN
rN
rN
rN
rN
rN
YB
"}
(4,1,1) = {"
rN
rN
rN
uM
uM
rN
rN
rN
rN
rN
rN
rN
rN
rN
rN
"}
(5,1,1) = {"
rN
rN
rN
rN
rN
rN
rN
rN
rN
rN
rN
rN
rN
rN
rN
"}
(6,1,1) = {"
rN
rN
rN
rN
rN
rN
rN
uM
uM
rN
rN
rN
rN
rN
rN
"}
(7,1,1) = {"
rN
rN
rN
rN
rN
rN
uM
uM
uM
rN
rN
rN
rN
rN
rN
"}
(8,1,1) = {"
rN
rN
rN
rN
rN
uM
uM
uM
uM
uM
rN
rN
rN
rN
rN
"}
(9,1,1) = {"
kA
rN
rN
rN
rN
rN
uM
uM
uM
uM
rN
rN
rN
rN
kA
"}
(10,1,1) = {"
rN
rN
rN
rN
rN
rN
uM
uM
uM
rN
rN
rN
rN
rN
rN
"}
(11,1,1) = {"
rN
rN
rN
rN
rN
rN
rN
rN
rN
rN
rN
rN
rN
rN
rN
"}
(12,1,1) = {"
rN
rN
uM
rN
rN
rN
rN
rN
rN
rN
rN
rN
rN
rN
rN
"}
(13,1,1) = {"
rN
rN
uM
uM
rN
rN
rN
rN
rN
rN
rN
rN
rN
rN
rN
"}
(14,1,1) = {"
YB
rN
uM
rN
rN
rN
rN
rN
rN
rN
rN
rN
kA
rN
uM
"}
(15,1,1) = {"
uM
rN
rN
rN
rN
uM
rN
rN
kA
rN
rN
rN
rN
kA
uM
"}
