//MAP CONVERTED BY dmm2tgm.py THIS HEADER COMMENT PREVENTS RECONVERSION, DO NOT REMOVE
"cp" = (
/obj/item/flashlight/flare/torch/metal,
/turf/open/floor/rogue/metal,
/area/rogue/under/town/sewer)
"cR" = (
/turf/open/floor/rogue/metal,
/area/rogue/under/town/sewer)
"kd" = (
/turf/open/floor/rogue/naturalstone,
/area/rogue/under/cave)
"mD" = (
/obj/effect/spawner/lootdrop/roguetown/sewers,
/turf/open/floor/rogue/blocks/green,
/area/rogue/under/town/sewer)
"no" = (
/obj/structure/roguerock,
/turf/open/floor/rogue/dirt,
/area/rogue/under/town/sewer)
"nM" = (
/turf/open/floor/rogue/blocks/green,
/area/rogue/under/town/sewer)
"nV" = (
/turf/open/water/sewer,
/area/rogue/under/town/sewer)
"qm" = (
/obj/structure/bars/grille,
/turf/open/floor/rogue/blocks/green,
/area/rogue/under/town/sewer)
"qp" = (
/obj/item/natural/rock,
/turf/open/floor/rogue/dirt,
/area/rogue/under/cave)
"rf" = (
/turf/closed/wall/mineral/rogue/stone/blue_moss,
/area/rogue/under/town/sewer)
"tS" = (
/mob/living/simple_animal/hostile/retaliate/rogue/bigrat,
/turf/open/floor/rogue/blocks/green,
/area/rogue/under/town/sewer)
"ua" = (
/mob/living/simple_animal/hostile/retaliate/rogue/bigrat/gethsmane,
/turf/open/floor/rogue/dirt,
/area/rogue/under/town/sewer)
"xx" = (
/obj/item/natural/rock,
/turf/open/floor/rogue/naturalstone,
/area/rogue/under/cave)
"yS" = (
/obj/effect/decal/remains/bigrat,
/turf/open/floor/rogue/blocks/green,
/area/rogue/under/town/sewer)
"Gy" = (
/turf/open/floor/rogue/naturalstone,
/area/rogue/under/town/sewer)
"KE" = (
/obj/item/natural/stone,
/turf/open/floor/rogue/naturalstone,
/area/rogue/under/town/sewer)
"Lk" = (
/turf/closed/mineral/random/rogue,
/area/rogue/under/town/sewer)
"Ol" = (
/obj/item/natural/bowstring,
/turf/open/floor/rogue/naturalstone,
/area/rogue/under/cave)
"RF" = (
/obj/structure/roguerock,
/turf/open/floor/rogue/naturalstone,
/area/rogue/under/cave)
"UW" = (
/turf/open/floor/rogue/metal/barograte,
/area/rogue/under/town/sewer)
"XV" = (
/turf/open/floor/rogue/dirt,
/area/rogue/under/cave)
"Yn" = (
/turf/closed/mineral/random/rogue,
/area/rogue/under/cave)
"Zk" = (
/obj/item/flashlight/flare/torch/metal,
/turf/open/floor/rogue/blocks/green,
/area/rogue/under/town/sewer)
"ZL" = (
/obj/structure/bars/grille,
/mob/living/simple_animal/hostile/retaliate/rogue/bigrat,
/turf/open/floor/rogue/blocks/green,
/area/rogue/under/town/sewer)
"ZV" = (
/obj/structure/bed/rogue/shit,
/turf/open/floor/rogue/blocks/green,
/area/rogue/under/town/sewer)

(1,1,1) = {"
Yn
kd
xx
XV
Yn
Yn
Yn
RF
Ol
rf
"}
(2,1,1) = {"
Yn
kd
qm
rf
rf
rf
rf
Gy
ua
rf
"}
(3,1,1) = {"
nV
nV
qm
ZL
yS
mD
rf
rf
Gy
Lk
"}
(4,1,1) = {"
Yn
rf
ZV
qm
nV
nV
nV
cR
UW
cR
"}
(5,1,1) = {"
kd
rf
mD
qm
nV
ZV
Zk
tS
nV
nV
"}
(6,1,1) = {"
cR
UW
cp
qm
nV
qm
qm
ZL
KE
rf
"}
(7,1,1) = {"
kd
nV
nV
qm
qm
ZL
nV
nV
qm
no
"}
(8,1,1) = {"
kd
kd
rf
rf
qm
nV
nV
yS
nM
rf
"}
(9,1,1) = {"
qp
kd
rf
rf
qm
Lk
Lk
qm
mD
rf
"}
(10,1,1) = {"
Yn
RF
XV
kd
kd
kd
Lk
nV
Lk
rf
"}
