//MAP CONVERTED BY dmm2tgm.py THIS HEADER COMMENT PREVENTS RECONVERSION, DO NOT REMOVE
"cR" = (
/obj/structure/roguetent,
/turf/open/floor/rogue/tile/checkeralt,
/area/rogue/under/cave)
"iw" = (
/obj/structure/closet/crate/chest/neu_fancy{
	locked = 1
	},
/obj/effect/decal/cleanable/dirt,
/mob/living/simple_animal/hostile/retaliate/rogue/bogtroll{
	name = "chest troll"
	},
/mob/living/simple_animal/hostile/retaliate/rogue/bogtroll{
	name = "chest troll"
	},
/mob/living/simple_animal/hostile/retaliate/rogue/bogtroll{
	name = "chest troll"
	},
/mob/living/simple_animal/hostile/retaliate/rogue/bogtroll{
	name = "chest troll"
	},
/turf/open/floor/rogue/tile,
/area/rogue/under/cave)
"iD" = (
/obj/structure/chair/stool/rogue,
/obj/effect/decal/cleanable/dirt,
/turf/open/floor/rogue/tile,
/area/rogue/under/cave)
"kd" = (
/turf/open/floor/rogue/naturalstone,
/area/rogue/under/cave)
"nV" = (
/turf/closed/wall/mineral/rogue/stone/blue_moss,
/area/rogue/under/cave)
"qp" = (
/obj/item/natural/rock,
/turf/open/floor/rogue/dirt,
/area/rogue/under/cave)
"rf" = (
/obj/item/natural/stone,
/turf/open/floor/rogue/dirt,
/area/rogue/under/cave)
"uj" = (
/obj/effect/decal/cleanable/dirt,
/obj/effect/decal/cleanable/dirt,
/obj/item/natural/bone,
/turf/open/floor/rogue/tile,
/area/rogue/under/cave)
"xx" = (
/obj/item/natural/rock,
/turf/open/floor/rogue/naturalstone,
/area/rogue/under/cave)
"Cb" = (
/obj/effect/spawner/trap,
/turf/open/floor/rogue/dirt,
/area/rogue/under/cave)
"JE" = (
/obj/effect/spawner/trap,
/turf/open/floor/rogue/naturalstone,
/area/rogue/under/cave)
"KE" = (
/obj/item/natural/stone,
/turf/open/floor/rogue/naturalstone,
/area/rogue/under/cave)
"Ol" = (
/obj/effect/decal/cleanable/dirt,
/turf/open/floor/rogue/tile/checkeralt,
/area/rogue/under/cave)
"RF" = (
/obj/structure/roguerock,
/turf/open/floor/rogue/naturalstone,
/area/rogue/under/cave)
"Vl" = (
/obj/effect/decal/cleanable/dirt,
/turf/open/floor/rogue/tile,
/area/rogue/under/cave)
"Wn" = (
/obj/effect/decal/cleanable/dirt,
/turf/open/floor/rogue/twig,
/area/rogue/under/cave)
"WD" = (
/obj/effect/decal/cleanable/dirt,
/obj/effect/decal/cleanable/dirt,
/turf/open/floor/rogue/tile,
/area/rogue/under/cave)
"XV" = (
/turf/open/floor/rogue/dirt,
/area/rogue/under/cave)
"Yn" = (
/turf/closed/mineral/random/rogue,
/area/rogue/under/cave)

(1,1,1) = {"
Yn
kd
kd
XV
Yn
Yn
Yn
kd
Yn
Yn
"}
(2,1,1) = {"
Yn
kd
xx
kd
rf
kd
kd
kd
Cb
Yn
"}
(3,1,1) = {"
Yn
Yn
kd
nV
nV
nV
nV
nV
kd
Yn
"}
(4,1,1) = {"
Yn
Yn
kd
nV
iD
WD
Wn
nV
kd
XV
"}
(5,1,1) = {"
JE
kd
kd
nV
iw
Vl
cR
Ol
KE
kd
"}
(6,1,1) = {"
Yn
Yn
kd
nV
uj
Vl
Wn
nV
KE
qp
"}
(7,1,1) = {"
Yn
Yn
kd
nV
nV
nV
nV
nV
XV
XV
"}
(8,1,1) = {"
Yn
Yn
KE
XV
kd
kd
kd
XV
qp
Yn
"}
(9,1,1) = {"
qp
kd
Yn
RF
kd
Yn
Yn
kd
Yn
Yn
"}
(10,1,1) = {"
Yn
kd
XV
JE
xx
kd
Yn
kd
Yn
XV
"}
