//MAP CONVERTED BY dmm2tgm.py THIS HEADER COMMENT PREVENTS RECONVERSION, DO NOT REMOVE
"aQ" = (
/turf/open/floor/rogue/twig,
/area/rogue/under/cave)
"aS" = (
/obj/machinery/light/rogue/torchholder/c,
/obj/structure/bed/rogue/inn/hay,
/turf/open/floor/rogue/twig,
/area/rogue/under/cave)
"cR" = (
/obj/structure/fluff/railing/border,
/turf/open/floor/rogue/twig,
/area/rogue/under/cave)
"dA" = (
/obj/item/fishingrod,
/obj/structure/fluff/railing/border{
	dir = 1;
	icon_state = "border"
	},
/turf/open/floor/rogue/twig,
/area/rogue/under/cave)
"gI" = (
/obj/structure/fluff/railing/border{
	dir = 5
	},
/obj/machinery/light/rogue/torchholder/l,
/turf/open/floor/rogue/twig,
/area/rogue/under/cave)
"kd" = (
/turf/open/floor/rogue/naturalstone,
/area/rogue/under/cave)
"ny" = (
/obj/structure/fluff/railing/border{
	dir = 5
	},
/obj/structure/fluff/railing/border{
	dir = 9
	},
/obj/structure/stairs{
	dir = 1
	},
/turf/open/floor/rogue/dirt,
/area/rogue/under/cave)
"nP" = (
/obj/structure/fluff/railing/border{
	dir = 9
	},
/turf/open/floor/rogue/naturalstone,
/area/rogue/under/cave)
"nV" = (
/obj/structure/flora/roguegrass/water,
/turf/open/water/ocean/deep,
/area/rogue/under/cave)
"pc" = (
/obj/structure/bed/rogue/inn/hay,
/turf/open/floor/rogue/twig,
/area/rogue/under/cave)
"qp" = (
/obj/item/natural/rock,
/turf/open/floor/rogue/dirt,
/area/rogue/under/cave)
"rf" = (
/obj/structure/roguetent,
/turf/open/floor/rogue/twig,
/area/rogue/under/cave)
"xx" = (
/obj/item/natural/rock,
/turf/open/floor/rogue/naturalstone,
/area/rogue/under/cave)
"BN" = (
/obj/structure/fluff/railing/border{
	dir = 4
	},
/turf/open/floor/rogue/twig,
/area/rogue/under/cave)
"Ck" = (
/turf/open/water/ocean/deep,
/area/rogue/under/cave)
"Fi" = (
/obj/structure/fluff/railing/border{
	dir = 1;
	icon_state = "border"
	},
/turf/open/floor/rogue/twig,
/area/rogue/under/cave)
"KE" = (
/obj/item/natural/stone,
/turf/open/floor/rogue/naturalstone,
/area/rogue/under/cave)
"Nl" = (
/obj/structure/flora/roguegrass/water,
/turf/open/water/ocean,
/area/rogue/under/cave)
"NW" = (
/obj/structure/fluff/railing/border{
	dir = 6
	},
/obj/structure/fluff/railing/border{
	icon_state = "border";
	dir = 10
	},
/turf/open/floor/rogue/twig,
/area/rogue/under/cave)
"Ol" = (
/obj/structure/fluff/railing/border{
	dir = 5
	},
/turf/open/floor/rogue/naturalstone,
/area/rogue/under/cave)
"OR" = (
/turf/closed/wall/mineral/rogue/tent,
/area/rogue/under/cave)
"Pc" = (
/obj/structure/fluff/railing/border{
	dir = 4
	},
/turf/open/floor/rogue/naturalstone,
/area/rogue/under/cave)
"PW" = (
/obj/structure/closet/crate/chest/wicker,
/obj/effect/spawner/lootdrop/roguetown/sewers,
/obj/structure/fluff/railing/border,
/turf/open/floor/rogue/dirt/road,
/area/rogue/under/cave)
"PX" = (
/turf/closed/wall/mineral/rogue/wooddark,
/area/rogue/under/cave)
"RF" = (
/obj/structure/roguerock,
/turf/open/floor/rogue/naturalstone,
/area/rogue/under/cave)
"WM" = (
/obj/effect/spawner/lootdrop/roguetown/sewers,
/turf/open/floor/rogue/twig,
/area/rogue/under/cave)
"XV" = (
/turf/open/floor/rogue/dirt,
/area/rogue/under/cave)
"Yn" = (
/turf/closed/mineral/random/rogue,
/area/rogue/under/cave)
"YQ" = (
/turf/open/water/ocean,
/area/rogue/under/cave)

(1,1,1) = {"
Yn
OR
PX
PX
OR
Yn
Yn
Pc
Ol
kd
"}
(2,1,1) = {"
Yn
OR
pc
aQ
rf
BN
gI
NW
ny
kd
"}
(3,1,1) = {"
Yn
OR
aS
WM
rf
YQ
Fi
PW
nP
kd
"}
(4,1,1) = {"
Yn
OR
PX
PX
OR
Ck
dA
cR
Yn
Yn
"}
(5,1,1) = {"
kd
kd
Nl
Ck
nV
Ck
Ck
Ck
Yn
kd
"}
(6,1,1) = {"
kd
kd
YQ
nV
Yn
nV
Ck
Ck
KE
qp
"}
(7,1,1) = {"
kd
YQ
YQ
Ck
nV
nV
nV
nV
Nl
XV
"}
(8,1,1) = {"
kd
kd
Nl
nV
Ck
Ck
Ck
YQ
YQ
Yn
"}
(9,1,1) = {"
qp
kd
Yn
RF
kd
Yn
Yn
kd
Yn
Yn
"}
(10,1,1) = {"
Yn
kd
XV
kd
xx
kd
Yn
kd
Yn
XV
"}
