//MAP CONVERTED BY dmm2tgm.py THIS HEADER COMMENT PREVENTS RECONVERSION, DO NOT REMOVE
"aJ" = (
/obj/item/natural/fur,
/turf/open/floor/rogue/sand,
/area/rogue/outdoors/woods/heavenscoast)
"eg" = (
/obj/effect/decal/remains/saiga,
/turf/open/floor/rogue/sand,
/area/rogue/outdoors/woods/heavenscoast)
"gB" = (
/obj/effect/roofing_helper/stone,
/turf/open/water/ocean,
/area/rogue/outdoors/woods/heavenscoast)
"ht" = (
/obj/structure/flora/roguetree/stump/log,
/turf/open/floor/rogue/sand,
/area/rogue/outdoors/woods/heavenscoast)
"lt" = (
/obj/structure/flora/roguetree/stump/burnt,
/turf/open/floor/rogue/sand,
/area/rogue/outdoors/woods/heavenscoast)
"nc" = (
/obj/item/natural/fibers,
/turf/open/floor/rogue/sand,
/area/rogue/outdoors/woods/heavenscoast)
"nq" = (
/obj/item/natural/hide,
/turf/open/floor/rogue/sand,
/area/rogue/outdoors/woods/heavenscoast)
"pj" = (
/obj/item/natural/rock,
/turf/open/floor/rogue/sand,
/area/rogue/outdoors/woods/heavenscoast)
"qC" = (
/turf/open/floor/rogue/dirt,
/area/rogue/outdoors/woods/heavenscoast)
"rN" = (
/obj/structure/flora/roguegrass/water/reeds,
/turf/open/water/ocean,
/area/rogue/outdoors/woods/heavenscoast)
"sX" = (
/obj/item/natural/bone,
/turf/open/floor/rogue/sand,
/area/rogue/outdoors/woods/heavenscoast)
"wj" = (
/obj/item/natural/stone,
/obj/structure/flora/roguegrass,
/turf/open/floor/rogue/sand,
/area/rogue/outdoors/woods/heavenscoast)
"xQ" = (
/obj/effect/roofing_helper/stone,
/turf/closed/mineral/random/rogue,
/area/rogue/indoors/shelter/woods)
"AC" = (
/obj/structure/flora/roguegrass,
/turf/open/floor/rogue/dirt/road,
/area/rogue/outdoors/woods/heavenscoast)
"AU" = (
/obj/item/natural/cloth,
/turf/open/floor/rogue/sand,
/area/rogue/outdoors/woods/heavenscoast)
"CZ" = (
/obj/effect/roofing_helper/stone,
/turf/open/floor/rogue/sand,
/area/rogue/outdoors/woods/heavenscoast)
"Dd" = (
/turf/open/floor/rogue/dirt/road,
/area/rogue/outdoors/woods/heavenscoast)
"FI" = (
/turf/open/water/ocean,
/area/rogue/outdoors/woods/heavenscoast)
"GL" = (
/turf/open/floor/rogue/sand,
/area/rogue/outdoors/woods/heavenscoast)
"Jc" = (
/obj/structure/flora/roguegrass,
/turf/open/floor/rogue/dirt,
/area/rogue/outdoors/woods/heavenscoast)
"Ke" = (
/obj/effect/decal/remains/saiga,
/turf/open/floor/rogue/dirt/road,
/area/rogue/outdoors/woods/heavenscoast)
"KC" = (
/obj/item/natural/rock,
/turf/open/floor/rogue/dirt/road,
/area/rogue/outdoors/woods/heavenscoast)
"KT" = (
/obj/structure/flora/roguegrass,
/turf/open/floor/rogue/sand,
/area/rogue/outdoors/woods/heavenscoast)

(1,1,1) = {"
GL
GL
GL
GL
GL
GL
GL
GL
GL
GL
KT
KT
qC
qC
qC
KT
KT
Jc
qC
qC
qC
GL
GL
KT
GL
"}
(2,1,1) = {"
KT
GL
GL
GL
FI
FI
FI
GL
GL
GL
GL
KT
GL
GL
qC
qC
qC
Dd
qC
qC
GL
KT
Dd
KT
Dd
"}
(3,1,1) = {"
KT
nq
GL
FI
rN
FI
qC
qC
qC
Dd
GL
KC
Dd
GL
sX
GL
GL
qC
qC
GL
Dd
GL
GL
pj
GL
"}
(4,1,1) = {"
KT
GL
GL
GL
FI
GL
xQ
xQ
qC
qC
qC
Dd
GL
Dd
GL
GL
ht
GL
GL
GL
GL
GL
GL
GL
GL
"}
(5,1,1) = {"
GL
GL
lt
GL
pj
xQ
xQ
xQ
Dd
GL
GL
GL
GL
Dd
GL
GL
GL
GL
lt
GL
GL
FI
rN
GL
Dd
"}
(6,1,1) = {"
GL
GL
GL
GL
GL
xQ
xQ
qC
qC
GL
GL
KT
GL
GL
FI
xQ
xQ
GL
GL
nc
FI
rN
FI
FI
GL
"}
(7,1,1) = {"
xQ
xQ
GL
GL
GL
GL
Dd
GL
GL
FI
GL
KT
KT
FI
xQ
xQ
xQ
xQ
GL
FI
FI
FI
FI
Dd
GL
"}
(8,1,1) = {"
xQ
xQ
xQ
GL
GL
qC
qC
GL
FI
FI
FI
rN
rN
rN
FI
xQ
xQ
xQ
GL
GL
xQ
GL
nc
Dd
GL
"}
(9,1,1) = {"
GL
xQ
FI
nc
GL
qC
GL
GL
FI
FI
rN
rN
rN
FI
FI
GL
GL
GL
GL
pj
GL
GL
xQ
GL
GL
"}
(10,1,1) = {"
GL
GL
FI
pj
GL
GL
GL
GL
GL
FI
GL
FI
FI
FI
GL
Ke
Dd
qC
GL
Dd
Dd
xQ
xQ
GL
GL
"}
(11,1,1) = {"
GL
FI
FI
FI
FI
GL
GL
FI
GL
GL
GL
GL
GL
GL
GL
GL
GL
qC
qC
Dd
GL
xQ
xQ
GL
GL
"}
(12,1,1) = {"
GL
FI
FI
rN
xQ
GL
FI
FI
rN
FI
xQ
GL
GL
xQ
FI
FI
FI
GL
GL
KT
GL
GL
GL
GL
wj
"}
(13,1,1) = {"
GL
FI
FI
rN
xQ
xQ
FI
FI
FI
rN
xQ
xQ
xQ
xQ
FI
FI
GL
GL
sX
GL
GL
KT
ht
KT
KT
"}
(14,1,1) = {"
GL
GL
FI
rN
xQ
xQ
GL
FI
FI
FI
FI
xQ
xQ
gB
CZ
CZ
xQ
xQ
xQ
KT
KT
GL
KT
GL
GL
"}
(15,1,1) = {"
qC
GL
FI
FI
xQ
xQ
GL
GL
GL
FI
GL
FI
FI
GL
GL
xQ
xQ
xQ
AU
KT
KT
KT
GL
qC
GL
"}
(16,1,1) = {"
qC
GL
FI
FI
rN
FI
GL
sX
GL
GL
GL
GL
KT
KT
AC
AC
GL
GL
GL
GL
GL
KT
KT
qC
qC
"}
(17,1,1) = {"
KT
KT
FI
FI
FI
FI
FI
qC
GL
AC
Jc
Jc
Jc
qC
GL
GL
FI
FI
FI
FI
FI
GL
lt
GL
GL
"}
(18,1,1) = {"
KT
GL
GL
FI
FI
GL
FI
qC
qC
KT
GL
KT
GL
pj
GL
GL
FI
FI
FI
FI
rN
GL
qC
qC
GL
"}
(19,1,1) = {"
GL
GL
GL
GL
GL
GL
GL
GL
qC
Dd
GL
GL
GL
GL
GL
FI
FI
FI
FI
FI
FI
GL
qC
qC
qC
"}
(20,1,1) = {"
GL
GL
GL
GL
GL
GL
GL
GL
GL
GL
xQ
GL
GL
GL
FI
FI
rN
rN
FI
GL
GL
pj
GL
qC
KT
"}
(21,1,1) = {"
GL
GL
ht
GL
FI
GL
lt
nc
GL
xQ
xQ
xQ
FI
FI
FI
rN
rN
FI
FI
FI
FI
xQ
xQ
GL
GL
"}
(22,1,1) = {"
GL
GL
GL
FI
rN
FI
GL
eg
GL
xQ
xQ
xQ
FI
FI
FI
FI
FI
FI
FI
FI
xQ
xQ
xQ
xQ
GL
"}
(23,1,1) = {"
GL
GL
FI
FI
FI
FI
FI
qC
qC
Dd
FI
FI
FI
GL
GL
FI
FI
GL
GL
GL
aJ
GL
GL
GL
nq
"}
(24,1,1) = {"
GL
KT
GL
FI
FI
GL
qC
qC
AC
GL
GL
GL
GL
GL
KT
KT
KT
GL
lt
GL
GL
KT
KT
GL
GL
"}
(25,1,1) = {"
GL
KT
KT
GL
GL
GL
GL
GL
GL
KT
KT
KT
KT
KT
KT
GL
KT
GL
GL
qC
GL
GL
GL
GL
GL
"}
