//MAP CONVERTED BY dmm2tgm.py THIS HEADER COMMENT PREVENTS RECONVERSION, DO NOT REMOVE
"aJ" = (
/obj/item/natural/fibers,
/turf/open/floor/rogue/sand,
/area/rogue/outdoors/woods/heavenscoast)
"gB" = (
/turf/closed/mineral/random/rogue,
/area/rogue/under/cave)
"ht" = (
/obj/structure/flora/roguetree/stump/log,
/turf/open/floor/rogue/sand,
/area/rogue/outdoors/woods/heavenscoast)
"iy" = (
/turf/open/water/ocean,
/area/rogue/outdoors/woods/heavenscoast)
"lt" = (
/obj/structure/flora/roguetree/stump/burnt,
/turf/open/floor/rogue/sand,
/area/rogue/outdoors/woods/heavenscoast)
"mz" = (
/obj/effect/roofing_helper/stone,
/obj/item/natural/stone,
/turf/open/floor/rogue/sand,
/area/rogue/outdoors/woods/heavenscoast)
"nq" = (
/obj/structure/flora/roguegrass/water/reeds,
/turf/open/water/ocean,
/area/rogue/outdoors/woods/heavenscoast)
"og" = (
/obj/item/natural/stone,
/turf/open/floor/rogue/sand,
/area/rogue/outdoors/woods/heavenscoast)
"pj" = (
/obj/effect/roofing_helper/stone,
/turf/closed/mineral/random/rogue,
/area/rogue/under/cave)
"rJ" = (
/obj/effect/roofing_helper/stone,
/turf/open/floor/rogue/sand,
/area/rogue/outdoors/woods/heavenscoast)
"rN" = (
/obj/structure/flora/roguegrass/water,
/turf/open/water/ocean,
/area/rogue/outdoors/woods/heavenscoast)
"sX" = (
/turf/open/transparent/openspace,
/area/rogue/outdoors/woods/heavenscoast)
"tn" = (
/obj/structure/spacevine,
/turf/open/floor/rogue/sand,
/area/rogue/outdoors/woods/heavenscoast)
"tS" = (
/obj/effect/roofing_helper/stone,
/obj/structure/flora/roguegrass,
/turf/open/floor/rogue/sand,
/area/rogue/outdoors/woods/heavenscoast)
"wj" = (
/obj/item/natural/stone,
/obj/structure/flora/roguegrass,
/turf/open/floor/rogue/sand,
/area/rogue/outdoors/woods/heavenscoast)
"xQ" = (
/turf/open/floor/rogue/naturalstone,
/area/rogue/outdoors/woods/heavenscoast)
"CZ" = (
/obj/item/natural/thorn,
/turf/open/floor/rogue/sand,
/area/rogue/outdoors/woods/heavenscoast)
"Dd" = (
/turf/open/floor/rogue/dirt,
/area/rogue/outdoors/woods/heavenscoast)
"GL" = (
/turf/open/floor/rogue/sand,
/area/rogue/outdoors/woods/heavenscoast)
"KT" = (
/obj/structure/flora/roguegrass,
/turf/open/floor/rogue/sand,
/area/rogue/outdoors/woods/heavenscoast)
"Pl" = (
/obj/effect/roofing_helper/stone,
/turf/open/transparent/openspace,
/area/rogue/outdoors/woods/heavenscoast)
"UM" = (
/turf/open/floor/rogue/ruinedwood,
/area/rogue/outdoors/woods/heavenscoast)
"Ze" = (
/obj/effect/roofing_helper/stone,
/turf/open/floor/rogue/naturalstone,
/area/rogue/outdoors/woods/heavenscoast)

(1,1,1) = {"
GL
lt
GL
GL
GL
GL
GL
GL
GL
Dd
Dd
iy
gB
iy
iy
"}
(2,1,1) = {"
aJ
tn
gB
gB
GL
GL
GL
Dd
GL
GL
gB
gB
gB
gB
iy
"}
(3,1,1) = {"
GL
gB
gB
gB
GL
Dd
gB
gB
GL
og
gB
gB
gB
gB
GL
"}
(4,1,1) = {"
GL
KT
KT
GL
Dd
Dd
gB
gB
GL
GL
xQ
gB
gB
gB
iy
"}
(5,1,1) = {"
og
KT
GL
GL
gB
KT
KT
iy
GL
KT
GL
xQ
xQ
nq
rN
"}
(6,1,1) = {"
GL
Dd
Dd
gB
gB
rN
nq
rN
rN
iy
GL
GL
xQ
GL
CZ
"}
(7,1,1) = {"
Dd
Dd
gB
gB
gB
gB
gB
rN
iy
GL
GL
GL
gB
gB
GL
"}
(8,1,1) = {"
KT
GL
gB
gB
gB
gB
gB
tn
GL
ht
GL
GL
gB
gB
tn
"}
(9,1,1) = {"
GL
gB
gB
gB
gB
gB
gB
gB
gB
gB
xQ
KT
GL
GL
GL
"}
(10,1,1) = {"
GL
gB
gB
gB
gB
gB
gB
gB
gB
xQ
xQ
KT
og
Dd
GL
"}
(11,1,1) = {"
GL
GL
gB
gB
gB
gB
gB
rN
GL
GL
xQ
gB
GL
Dd
Dd
"}
(12,1,1) = {"
GL
GL
GL
gB
gB
rN
nq
iy
GL
GL
gB
gB
gB
Dd
Dd
"}
(13,1,1) = {"
GL
gB
GL
Dd
gB
iy
GL
GL
GL
gB
gB
gB
gB
gB
Dd
"}
(14,1,1) = {"
GL
gB
gB
GL
GL
GL
GL
Dd
GL
gB
gB
rN
iy
aJ
GL
"}
(15,1,1) = {"
GL
gB
gB
GL
GL
wj
Dd
Dd
Dd
GL
rN
iy
GL
KT
lt
"}

(1,1,2) = {"
sX
sX
sX
sX
sX
sX
sX
sX
sX
sX
sX
sX
pj
sX
sX
"}
(2,1,2) = {"
sX
sX
pj
pj
sX
sX
sX
sX
sX
sX
og
GL
pj
pj
sX
"}
(3,1,2) = {"
sX
GL
GL
rJ
sX
sX
GL
xQ
UM
UM
KT
xQ
pj
pj
sX
"}
(4,1,2) = {"
sX
sX
sX
Pl
sX
sX
GL
GL
sX
sX
sX
xQ
xQ
GL
sX
"}
(5,1,2) = {"
sX
sX
sX
Pl
rJ
sX
UM
sX
sX
sX
sX
sX
UM
sX
sX
"}
(6,1,2) = {"
sX
sX
sX
KT
mz
sX
UM
sX
sX
sX
sX
sX
UM
sX
sX
"}
(7,1,2) = {"
sX
sX
GL
xQ
Ze
GL
GL
sX
sX
sX
sX
sX
KT
GL
sX
"}
(8,1,2) = {"
sX
sX
GL
pj
pj
pj
aJ
sX
sX
sX
sX
sX
GL
xQ
sX
"}
(9,1,2) = {"
sX
GL
xQ
pj
pj
pj
KT
GL
GL
GL
sX
sX
sX
sX
sX
"}
(10,1,2) = {"
sX
GL
GL
pj
pj
pj
rJ
rJ
rJ
sX
sX
sX
sX
sX
sX
"}
(11,1,2) = {"
sX
sX
GL
GL
GL
GL
GL
sX
Pl
Pl
Pl
tS
sX
sX
sX
"}
(12,1,2) = {"
sX
sX
UM
og
GL
sX
sX
sX
sX
sX
xQ
pj
GL
sX
sX
"}
(13,1,2) = {"
sX
GL
UM
sX
GL
sX
sX
sX
sX
xQ
pj
pj
pj
aJ
sX
"}
(14,1,2) = {"
sX
GL
GL
sX
sX
sX
sX
sX
sX
GL
GL
sX
sX
sX
sX
"}
(15,1,2) = {"
sX
GL
GL
sX
sX
sX
sX
sX
sX
sX
sX
sX
sX
sX
sX
"}
